ϣ̄ⲁϩⲣⲁⲓ̈	ϣⲁϩⲣⲁⲓ
ϣ̇ϣⲉ	ϣϣⲉ
ϣ̇ϥⲉ	ϣϥⲉ
ϣ̇ⲃⲛ̇ⲛⲉ	ϣⲃⲛⲛⲉ
ϣ̇ⲗⲏⲗ	ϣⲗⲏⲗ
ϣ̇ⲙⲟⲩⲛⲉ	ϣⲙⲟⲩⲛⲉ
ϣ̇ⲙⲟⲩⲛ	ϣⲙⲟⲩⲛ
ϣ̇ⲡⲛ̇ϣⲱⲡ	ϣⲡⲛϣⲱⲡ
ϣ̇ⲥ̇ⲛⲉ	ϣⲥⲛⲉ
ϣ̇ⲥ	ϣⲥ
ϣ̇ⲧⲏⲛ	ϣⲧⲏⲛ
ϣ̇ⲧⲟⲣⲧ̇ⲣ	ϣⲧⲟⲣⲧⲣ
ϣ̇ⲧⲟⲣⲧⲣ̇	ϣⲧⲟⲣⲧⲣ
ϣ̇ⲱⲡⲉ	ϣⲱⲡⲉ
ϣ̣ⲁ̣ϫⲉ	ϣⲁϫⲉ
ϣ̣ⲁ̣	ϣⲁ
ϣ̣ⲏ̣ⲣⲉ	ϣⲏⲣⲉ
ϣ̣ⲏⲣⲉ	ϣⲏⲣⲉ
ϣ̣ⲗ̣ⲟ̣ϥ	ϣⲗⲟϥ
ϣ̣︤ϫ︥ⲥⲟϭ	ϣϫⲥⲟϭ
ϣ̣[ⲃ]ⲃⲓⲱ	ϣⲃⲃⲓⲱ
ϣϣⲉ	ϣϣⲉ
ϣϥⲉ`	ϣϥⲉ
ϣϭⲙ̄ϭⲟⲙ	ϣϭⲙϭⲟⲙ
ϣϭⲙ̇ϭⲟⲙ	ϣϭⲙϭⲟⲙ
ϣϭⲟⲙ	ϣϭⲟⲙ
ϣϭⲟⲙ	ϣϭⲟⲙ
ϣϭⲟⲙ`	ϣϭⲟⲙ
ϣⲁϩⲣⲁⲓ̈	ϣⲁϩⲣⲁⲓ
ϣⲁϩⲣⲁⲓ	ϣⲁϩⲣⲁⲓ
ϣⲁϩ`	ϣⲁϩ
ϣⲁϫⲉ⳿	ϣⲁϫⲉ
ϣⲁϫⲉ	ϣⲁϫⲉ
ϣⲁϫⲉ	ϣⲁϫⲉ
ϣⲁϫⲉ`	ϣⲁϫⲉ
ϣⲁϫⲉ`	ϣⲁϫⲉ
ϣⲁⲁ̇ⲧ	ϣⲁⲁⲧ
ϣⲁⲁⲧ︤	ϣⲁⲁⲧ
ϣⲁⲁⲧ︤	ϣⲁⲁⲧ
ϣⲁⲁⲧ	ϣⲁⲁⲧ
ϣⲁⲁ	ϣⲁⲁ
ϣⲁⲛⲧⲉ	ϣⲁⲛⲧⲉ
ϣⲁⲛⲧ	ϣⲁⲛⲧ
ϣⲁⲛ	ϣⲁⲛ
ϣⲁⲣⲉ	ϣⲁⲣⲉ
ϣⲁⲣⲉ	ϣⲁⲣⲉ
ϣⲁⲣⲟ	ϣⲁⲣⲟ
ϣⲁⲣⲱ	ϣⲁⲣⲱ
ϣⲁⲣⲱ	ϣⲁⲣⲱ
ϣⲁⲣ[ⲟ̣]	ϣⲁⲣⲟ
ϣⲁⲧⲟⲩ	ϣⲁⲧⲟⲩ
ϣⲁ⳯ⲧ	ϣⲁⲛⲧ
ϣⲁ⳯	ϣⲁⲛ
ϣⲁ	ϣⲁ
ϣⲁ	ϣⲁ
ϣⲁ	ϣⲁ
ϣⲁ	ϣⲁ
ϣⲁ]ⲛ̣	ϣⲛ
ϣⲁ`	ϣⲁ
ϣⲃⲉⲉⲣ`	ϣⲃⲉⲉⲣ
ϣⲃ︤ⲣ︥	ϣⲃⲣ
ϣⲉⲉⲣⲉ	ϣⲉⲉⲣⲉ
ϣⲉⲉⲣⲉ`	ϣⲉⲉⲣⲉ
ϣⲉⲡϣ︤ⲡ︥	ϣⲉⲡϣⲡ
ϣⲉ	ϣⲉ
ϣⲏⲓ̈	ϣⲏⲓ
ϣⲏⲙ⳿	ϣⲏⲙ
ϣⲏⲙ	ϣⲏⲙ
ϣⲏⲣⲉ	ϣⲏⲣⲉ
ϣⲏⲣⲉ`	ϣⲏⲣⲉ
ϣⲏ⳯	ϣⲏⲛ
ϣⲏ[ⲣ̣]ⲉ	ϣⲏⲣⲉ
ϣⲓ̇ⲏⲧ	ϣⲓⲏⲧ
ϣⲓ̇	ϣⲓ
ϣⲓⲃⲉ	ϣⲓⲃⲉ
ϣⲓⲛⲉ	ϣⲓⲛⲉ
ϣⲓⲛⲉ	ϣⲓⲛⲉ
ϣⲓⲛⲉ`	ϣⲓⲛⲉ
ϣⲓⲡⲉ	ϣⲓⲡⲉ
ϣⲓⲡⲉ	ϣⲓⲡⲉ
ϣⲓⲧⲉ⳿	ϣⲓⲧⲉ
ϣⲓ	ϣⲓ
ϣⲗⲏⲗ⳿	ϣⲗⲏⲗ
ϣⲗⲏⲗ	ϣⲗⲏⲗ
ϣⲗⲏⲗ	ϣⲗⲏⲗ
ϣⲗⲏⲗ`	ϣⲗⲏⲗ
ϣⲙ̇ⲙⲟ	ϣⲙⲙⲟ
ϣⲙⲙⲟ	ϣⲙⲙⲟ
ϣⲙⲙⲟ`	ϣⲙⲙⲟ
ϣⲟ̇ⲟⲡ	ϣⲟⲟⲡ
ϣⲟϣⲟⲩ	ϣⲟϣⲟⲩ
ϣⲟϫⲛⲉ	ϣⲟϫⲛⲉ
ϣⲟϫⲛⲉ`	ϣⲟϫⲛⲉ
ϣⲟⲕ︤ϩ︥	ϣⲟⲕϩ
ϣⲟⲙⲛⲧ̇	ϣⲟⲙⲛⲧ
ϣⲟⲙ︤ⲧ︥	ϣⲟⲙⲧ
ϣⲟⲛⲧⲉ⳿	ϣⲟⲛⲧⲉ
ϣⲟⲟ̇ⲡ	ϣⲟⲟⲡ
ϣⲟⲟⲡ̂	ϣⲟⲟⲡ
ϣⲟⲟⲡ⳿	ϣⲟⲟⲡ
ϣⲟⲟⲡ	ϣⲟⲟⲡ
ϣⲟⲟⲡ`	ϣⲟⲟⲡ
ϣⲟⲟⲧⲓ	ϣⲟⲟⲡ
ϣⲟⲟⲩⲉ	ϣⲟⲟⲩⲉ
ϣⲟⲟⲩ	ϣⲟⲟⲩ
ϣⲟⲡ̣	ϣⲟⲡ
ϣⲟⲡ︤	ϣⲟⲡ
ϣⲟⲣϣ︤ⲣ︥	ϣⲟⲣϣⲣ
ϣⲟⲣⲡ̣	ϣⲟⲣⲡ
ϣⲟⲣ︤ⲡ︥	ϣⲟⲣⲡ
ϣⲟⲣ︤ⲡ︥`	ϣⲟⲣⲡ
ϣⲟⲩϣⲟⲩ	ϣⲟⲩϣⲟⲩ
ϣⲟⲩϣⲧ̇	ϣⲟⲩϣⲧ
ϣⲟⲩⲉⲓⲧ`	ϣⲟⲩⲉⲓⲧ
ϣⲟⲩⲱ	ϣⲟⲩⲱ
ϣⲟ[ⲣⲡ̄	ϣⲟⲣⲡ
ϣⲟ]ⲟ̣ⲡ`	ϣⲟⲟⲡ
ϣⲡⲏⲣⲉ	ϣⲡⲏⲣⲉ
ϣⲧⲁⲙ`	ϣⲧⲁⲙ
ϣⲱϥ︤ⲧ︥	ϣⲱϥⲧ
ϣⲱϫ︤ⲡ̣︥	ϣⲱϫⲡ
ϣⲱⲗ	ϣⲱⲗ
ϣⲱⲙ	ϣⲱⲙ
ϣⲱⲛ̣ⲉ	ϣⲱⲛⲉ
ϣⲱⲛ̣ⲉ	ϣⲱⲛⲉ
ϣⲱⲛⲉ	ϣⲱⲛⲉ
ϣⲱⲛⲉ`	ϣⲱⲛⲉ
ϣⲱⲡ̣ⲉ	ϣⲱⲡⲉ
ϣⲱⲡⲉ̣	ϣⲱⲡⲉ
ϣⲱⲡⲉ	ϣⲱⲡⲉ
ϣⲱⲡⲉ`	ϣⲱⲡⲉ
ϣⲱⲡⲉ`	ϣⲱⲡⲉ`
ϣⲱⲡ⳿	ϣⲱⲡ
ϣⲱⲡ	ϣⲱⲡ
ϣⲱⲣ︤ⲡ︥	ϣⲱⲣⲡ
ϣⲱⲣ︤ⲡ︥`	ϣⲱⲣⲡ
ϣⲱⲥ̇ⲙ	ϣⲱⲥⲙ
ϣⲱⲱⲡⲉ	ϣⲱⲱⲡⲉ
ϣⲱⲱⲡⲉ	ϣⲱⲱⲡⲉ
ϣⲱⲱⲧ⳿	ϣⲱⲱⲧ
ϣⲱⲱⲧ	ϣⲱⲱⲧ
ϣⲱⲱⲧ`	ϣⲱⲱⲧ
ϣⲱ]ⲡⲉ	ϣⲱⲡⲉ
ϣ̣︤ⲡ̣︥	ϣⲡ
ϣ︤ⲃ︥ⲃⲓⲱ	ϣⲃⲃⲓⲱ
ϣ︤ⲃ︥ⲉⲓⲱ̂	ϣⲃⲉⲓⲱ
ϣ︤ⲃ︦ⲣ︥	ϣⲃⲣ
ϣ︤ⲙ︥ϣⲉ	ϣⲙϣⲉ
ϣ︤ⲙ︥ⲙⲟ̂	ϣⲙⲙⲟ
ϣ︤ⲙ︥ⲙⲟ`	ϣⲙⲙⲟ
ϣ︤ⲛ︥	ϣⲛ
ϣ︤ⲡ︥	ϣⲡ
ϣ︤ⲣ︥ⲡ	ϣⲣⲡ
ϣ︤ⲣ︦ⲡ︥	ϣⲣⲡ
ϣ︦ⲙ︥ϣⲉ	ϣⲙϣⲉ
ϣ	ϣ
ϣ[ⲟ]ⲟⲡ	ϣⲟⲟⲡ
Ϥⲓ	ϥⲓ
Ϥ	ϥ
ϥ̀	ϥ
ϥ̄	ϥ
ϥ̇	ϥ
ϥ̇	ϥ
ϥ̣	ϥ
ϥ̣	ϥ
ϥ̣	ϥ
ϥⲉⲓ̇ⲣⲟⲟⲩϣ̇	ϥⲉⲓⲣⲟⲟⲩϣ
ϥⲓ̂	ϥⲓ
ϥⲓ̇ⲧ̇	ϥⲓⲧ
ϥⲓ̇	ϥⲓ
ϥⲓ̈	ϥⲓ
ϥⲓ̣	ϥⲓ
ϥⲓⲧ	ϥⲓⲧ
ϥⲓ	ϥⲓ
ϥⲓ`	ϥⲓ
ϥⲟⲧ	ϥⲟⲧ
ϥⲱⲧⲉ`	ϥⲱⲧⲉ
ϥ⳿	ϥ
ϥ︥	ϥ
ϥ︥	ϥ
ϥ︥`	ϥ
ϥ	ϥ
ϥ	ϥ
ϥ	ϥ
ϥ	ϥ
ϥ]	ϥ
ϥ]	ϥ
ϥ`	ϥ
ϥ`	ϥ
Ϩⲁⲙⲟⲓ̈	ϩⲁⲙⲟⲓ
Ϩⲁⲙⲟⲓ	ϩⲁⲙⲟⲓ
Ϩⲉⲛ	ϩⲉⲛ
Ϩⲉ	ϩⲉ
Ϩⲙ	ϩⲙ
Ϩⲣⲁⲭⲏⲗ`	ϩⲣⲁⲭⲏⲗ
Ϩⲱⲃ⳿	ϩⲱⲃ
Ϩⲱⲱ	ϩⲱⲱ
Ϩ︤ⲙ︥	ϩⲙ
ϩ̄ⲗ̄ⲗⲟ⳿	ϩⲗⲗⲟ
ϩ̄ⲗⲗⲟ	ϩⲗⲗⲟ
ϩ̇ⲗⲗⲟ	ϩⲗⲗⲟ
ϩ̇ⲗⲡ̇ⲗⲱⲡ	ϩⲗⲡⲗⲱⲡ
ϩ̇ⲙⲉ	ϩⲙⲉ
ϩ̇ⲙⲟⲟⲥ	ϩⲙⲟⲟⲥ
ϩ̇ⲙⲟⲟⲥ	ϩⲙⲟⲟⲥ
ϩ̇ⲙⲟⲧ	ϩⲙⲟⲧ
ϩ̇ⲙ	ϩⲙ
ϩ̇ⲛ	ϩⲛ
ϩ̇ⲣⲁⲙⲛⲟⲥ	ϩⲣⲁⲙⲛⲟⲥ
ϩ̇ⲧⲟⲣ	ϩⲧⲟⲣ
ϩ̣ⲁ̣ⲣⲉϩ	ϩⲁⲣⲉϩ
ϩ̣ⲁ̣ⲧ	ϩⲁⲧ
ϩ̣ⲁⲣⲉϩ	ϩⲁⲣⲉϩ
ϩ̣ⲉⲛ	ϩⲉⲛ
ϩ̣ⲓ̣ⲧⲟⲩⲱ	ϩⲓⲧⲟⲩⲱ
ϩ̣ⲙ	ϩⲙ
ϩ̣ⲙ]	ϩⲙ
ϩ̣ⲛ̣	ϩⲛ
ϩ̣ⲛ	ϩⲛ
ϩ̣ⲱⲃ	ϩⲱⲃ
ϩⲁ̣ⲧⲏ	ϩⲁⲧⲏ
ϩⲁϩ̣`	ϩⲁϩ
ϩⲁϩⲧⲏ̣	ϩⲁϩⲧⲏ
ϩⲁϩⲧⲏ	ϩⲁϩⲧⲏ
ϩⲁϩⲧⲛ̇	ϩⲁϩⲧⲛ
ϩⲁϩⲧⲛ	ϩⲁϩⲧⲛ
ϩⲁϩ	ϩⲁϩ
ϩⲁϩ`	ϩⲁϩ
ϩⲁⲁⲩ	ϩⲁⲁⲩ
ϩⲁⲃⲟⲗ	ϩⲁⲃⲟⲗ
ϩⲁⲅⲓ̈ⲟⲥ	ϩⲁⲅⲓⲟⲥ
ϩⲁⲉ	ϩⲁⲉ
ϩⲁⲓ̈	ϩⲁⲓ
ϩⲁⲗⲁⲁ̇ⲧⲉ	ϩⲁⲗⲁⲁⲧⲉ
ϩⲁⲗⲁⲧⲉ`	ϩⲁⲗⲁⲧⲉ
ϩⲁⲗ`	ϩⲁⲗ
ϩⲁⲙ̣[ⲟⲓ	ϩⲁⲙⲟⲓ
ϩⲁⲙϣⲉ	ϩⲁⲙϣⲉ
ϩⲁⲙⲕ︤ⲗ︥ⲗⲉ	ϩⲁⲙⲕⲗⲗⲉ
ϩⲁⲙⲟⲓ̈	ϩⲁⲙⲟⲓ
ϩⲁⲡⲥ̇	ϩⲁⲡⲥ
ϩⲁⲡ	ϩⲁⲡ
ϩⲁⲣⲁⲧ︤	ϩⲁⲣⲁⲧ
ϩⲁⲣⲁⲧ	ϩⲁⲣⲁⲧ
ϩⲁⲣⲉ̣[ϩ]	ϩⲁⲣⲉϩ
ϩⲁⲣⲉϩ	ϩⲁⲣⲉϩ
ϩⲁⲣⲉϩ`	ϩⲁⲣⲉϩ
ϩⲁⲣⲓϩⲁⲣⲟ	ϩⲁⲣⲓϩⲁⲣⲟ
ϩⲁⲣⲟ	ϩⲁⲣⲟ
ϩⲁⲣⲱ	ϩⲁⲣⲱ
ϩⲁⲣ︤ϣ̣︥ϩⲏⲧ	ϩⲁⲣϣϩⲏⲧ
ϩⲁⲣ︤ϣ︥ϩⲏⲧ⳿	ϩⲁⲣϣϩⲏⲧ
ϩⲁⲣ[ⲟ	ϩⲁⲣⲟ
ϩⲁⲧ̣︤ⲛ	ϩⲁⲧⲛ
ϩⲁⲧⲏ̂	ϩⲁⲧⲏ
ϩⲁⲧⲏ̇	ϩⲁⲧⲏ
ϩⲁⲧⲏ	ϩⲁⲧⲏ
ϩⲁⲧⲛ̣	ϩⲁⲧⲛ
ϩⲁⲧ︤ⲛ︥	ϩⲁⲧⲛ
ϩⲁⲧ	ϩⲁⲧ
ϩⲁⲧ]	ϩⲁⲧ
ϩⲁ	ϩⲁ
ϩⲁ]ⲧ︤ⲛ︥	ϩⲁⲧⲛ
ϩⲃⲏⲟⲩⲉ`	ϩⲃⲏⲩⲉ
ϩⲃⲏⲩⲉ	ϩⲃⲏⲩⲉ
ϩⲃⲏⲩⲉ`	ϩⲃⲏⲩⲉ
ϩⲉⲑⲛⲓⲕⲟⲥ	ϩⲉⲑⲛⲓⲕⲟⲥ
ϩⲉⲑⲛⲓⲕⲟⲥ`	ϩⲉⲑⲛⲓⲕⲟⲥ
ϩⲉⲑⲛⲟⲥ⳿	ϩⲉⲑⲛⲟⲥ
ϩⲉⲑⲛⲟⲥ`	ϩⲉⲑⲛⲟⲥ
ϩⲉⲗⲗⲏⲛ⳿	ϩⲉⲗⲗⲏⲛ
ϩⲉⲗⲡⲓⲍⲉ⳿	ϩⲉⲗⲡⲓⲍⲉ
ϩⲉⲗⲡⲓⲍⲉ	ϩⲉⲗⲡⲓⲍⲉ
ϩⲉⲗⲡⲓⲥ⳿	ϩⲉⲗⲡⲓⲥ
ϩⲉⲛ̣	ϩⲉⲛ
ϩⲉⲛⲉⲉⲧⲏ	ϩⲉⲛⲉⲉⲧⲏ
ϩⲉⲛ	ϩⲉⲛ
ϩⲉⲡ⳿	ϩⲉⲡ
ϩⲉⲣⲙⲁⲛ	ϩⲉⲣⲙⲁⲛ
ϩⲉⲣⲙⲏⲥ	ϩⲉⲣⲙⲏⲥ
ϩⲉⲻ	ϩⲉⲛ
ϩⲉ⳯	ϩⲉⲛ
ϩⲉ⳿	ϩⲉ
ϩⲉ⳿	ϩⲉ
ϩⲉ	ϩⲉ
ϩⲉ	ϩⲉ
ϩⲉ`	ϩⲉ
ϩⲏ̣ⲧ	ϩⲏⲧ
ϩⲏ̣[ⲧ]	ϩⲏⲧ
ϩⲏⲃⲥ	ϩⲏⲃⲥ
ϩⲏⲃ︤ⲥ︥	ϩⲏⲃⲥ
ϩⲏⲃ︤ⲥ︥`	ϩⲏⲃⲥ
ϩⲏⲅⲉⲙⲱⲛ	ϩⲏⲅⲉⲙⲱⲛ
ϩⲏⲅⲉⲙⲱⲛ`	ϩⲏⲅⲉⲙⲱⲛ
ϩⲏⲏ̇ⲧⲉ	ϩⲏⲏⲧⲉ
ϩⲏⲏⲛⲉ`	ϩⲏⲏⲛⲉ
ϩⲏⲕⲉ⳿	ϩⲏⲕⲉ
ϩⲏⲕⲉ	ϩⲏⲕⲉ
ϩⲏⲡ	ϩⲏⲡ
ϩⲏⲧ⳿	ϩⲏⲧ
ϩⲏⲧ︤ⲛ︥	ϩⲏⲧⲛ
ϩⲏⲧ︤ⲛ︥`	ϩⲏⲧⲛ
ϩⲏⲧ︤	ϩⲏⲧ
ϩⲏⲧ	ϩⲏⲧ
ϩⲏⲧ`	ϩⲏⲧ
ϩⲏⲩ	ϩⲏⲩ
ϩⲏⲩ	ϩⲏⲩ
ϩⲏ	ϩⲏ
ϩⲏ[..]ⲉ̣	ϩⲏ[..]ⲉ
ϩⲓ̇ⲏ̇	ϩⲓⲏ
ϩⲓ̇ⲥⲉ	ϩⲓⲥⲉ
ϩⲓ̇ⲱ̇ⲱ	ϩⲓⲱⲱ
ϩⲓ̇ⲱⲱ	ϩⲓⲱⲱ
ϩⲓ̇	ϩⲓ
ϩⲓϫⲛ̇	ϩⲓϫⲛ
ϩⲓϫⲱ	ϩⲓϫⲱ
ϩⲓϫ︤ⲙ︥	ϩⲓϫⲙ
ϩⲓϫ︤ⲛ︥	ϩⲓϫⲛ
ϩⲓⲃⲟⲗ	ϩⲓⲃⲟⲗ
ϩⲓⲃⲱ	ϩⲓⲃⲱ
ϩⲓⲉⲣⲉⲩⲥ̇	ϩⲓⲉⲣⲉⲩⲥ
ϩⲓⲕⲱⲛ`	ϩⲓⲕⲱⲛ
ϩⲓⲙⲉ	ϩⲓⲙⲉ
ϩⲓⲛⲏⲃ	ϩⲓⲛⲏⲃ
ϩⲓⲟⲙⲉ	ϩⲓⲟⲙⲉ
ϩⲓⲟⲙⲉ`	ϩⲓⲟⲙⲉ
ϩⲓⲟⲛⲉ`	ϩⲓⲟⲛⲉ
ϩⲓⲟⲟⲩⲉ	ϩⲓⲟⲟⲩⲉ
ϩⲓⲥⲉ	ϩⲓⲥⲉ
ϩⲓⲥⲉ`	ϩⲓⲥⲉ
ϩⲓⲧⲙ̄	ϩⲓⲧⲙ
ϩⲓⲧⲙ	ϩⲓⲧⲙ
ϩⲓⲧⲛ	ϩⲓⲧⲛ
ϩⲓⲧⲟⲟ̇ⲧ	ϩⲓⲧⲟⲟⲧ
ϩⲓⲧⲟⲟⲧ︤	ϩⲓⲧⲟⲟⲧ
ϩⲓⲧⲟⲟⲧ	ϩⲓⲧⲟⲟⲧ
ϩⲓⲧⲟⲩⲱ	ϩⲓⲧⲟⲩⲱ
ϩⲓⲧ︤ⲙ︥	ϩⲓⲧⲙ
ϩⲓⲧ︤ⲛ̣︥	ϩⲓⲧⲛ
ϩⲓⲧ︤ⲛ︥	ϩⲓⲧⲛ
ϩⲓ	ϩⲓ
ϩⲓ	ϩⲓ
ϩⲓ]ϫⲛ	ϩⲓϫⲛ
ϩⲕⲁⲉⲓⲧ⳿	ϩⲕⲁⲉⲓⲧ
ϩⲕⲟ	ϩⲕⲟ
ϩⲕⲟ	ϩⲕⲟ
ϩⲗ̄ⲗⲟⲉⲓ	ϩⲗⲗⲟⲓ
ϩⲗ̇ⲗⲟ	ϩⲗⲗⲟ
ϩⲗⲗⲟ⳿	ϩⲗⲗⲟ
ϩⲗⲗⲟ	ϩⲗⲗⲟ
ϩⲙ̄	ϩⲙ
ϩⲙ̇ⲟⲟ̇ⲥ	ϩⲙⲟⲟⲥ
ϩⲙ̇ⲟⲟⲥ	ϩⲙⲟⲟⲥ
ϩⲙ̇	ϩⲙ
ϩⲙ̇	ϩⲙ
ϩⲙϩⲁⲗ	ϩⲙϩⲁⲗ
ϩⲙⲉ⳿	ϩⲙⲉ
ϩⲙⲉ	ϩⲙⲉ
ϩⲙⲟⲟⲥ	ϩⲙⲟⲟⲥ
ϩⲙⲟⲟ	ϩⲙⲟⲟ
ϩⲙⲟⲧ	ϩⲙⲟⲧ
ϩⲙ︥ϩⲁⲗ`	ϩⲙϩⲁⲗ
ϩⲙ︥	ϩⲙ
ϩⲙ	ϩⲙ
ϩⲛ̄	ϩⲛ
ϩⲛ̇	ϩⲉⲛ
ϩⲛ̇	ϩⲛ
ϩⲛⲁⲁⲩ	ϩⲛⲁⲁⲩ
ϩⲛⲁⲁⲩ`	ϩⲛⲁⲁⲩ
ϩⲛⲁⲩ	ϩⲛⲁⲩ
ϩⲛⲁⲩ	ϩⲛⲁⲩ
ϩⲛⲁⲩ`	ϩⲛⲁⲩ
ϩⲛⲁ	ϩⲛⲁ
ϩⲛⲏ	ϩⲛⲏ
ϩⲛⲟ̂	ϩⲛⲟ
ϩⲛⲟ⳿	ϩⲛⲟ
ϩⲛⲟ	ϩⲛⲟ
ϩⲛ︥	ϩⲛ
ϩⲛ	ϩⲛ
ϩⲛ]	ϩⲛ
ϩⲟ̂	ϩⲟ
ϩⲟϥ	ϩⲟϥ
ϩⲟϫ︤ϩ︥ϫ	ϩⲟϫϩϫ
ϩⲟⲉⲓⲧⲉ	ϩⲟⲉⲓⲧⲉ
ϩⲟⲓ̇ⲛⲉ	ϩⲟⲓⲛⲉ
ϩⲟⲓ̇ⲧⲉ	ϩⲟⲓⲧⲉ
ϩⲟⲓ̈ⲛⲉ	ϩⲟⲓⲛⲉ
ϩⲟⲓ̈ⲛⲉ`	ϩⲟⲓⲛⲉ
ϩⲟⲓ̈	ϩⲟⲓ
ϩⲟⲗϭ̇	ϩⲟⲗϭ
ϩⲟⲗⲟⲕⲟⲧⲧⲓ̇ⲛⲟⲥ	ϩⲟⲗⲟⲕⲟⲧⲧⲓⲛⲟⲥ
ϩⲟⲗⲱⲥ⳿	ϩⲟⲗⲱⲥ
ϩⲟⲗⲱⲥ	ϩⲟⲗⲱⲥ
ϩⲟⲗ︤ϭ︥	ϩⲟⲗϭ
ϩⲟⲙⲟⲗⲟⲅⲉⲓ	ϩⲟⲙⲟⲗⲟⲅⲉⲓ
ϩⲟⲙ︤ⲧ︥	ϩⲟⲙⲧ
ϩⲟⲟⲗⲉ	ϩⲟⲟⲗⲉ
ϩⲟⲟⲩ̣`	ϩⲟⲟⲩ
ϩⲟⲟⲩϣ	ϩⲟⲟⲩϣ
ϩⲟⲟⲩⲧ	ϩⲟⲟⲩⲧ
ϩⲟⲟⲩⲧ`	ϩⲟⲟⲩⲧ
ϩⲟⲟⲩ	ϩⲟⲟⲩ
ϩⲟⲟⲩ	ϩⲟⲟⲩ
ϩⲟⲟⲩ`	ϩⲟⲟⲩ
ϩⲟⲣ︤ϣ︥	ϩⲟⲣϣ
ϩⲟⲥⲟⲛ`	ϩⲟⲥⲟⲛ
ϩⲟⲥⲟ⳯	ϩⲟⲥⲟⲛ
ϩⲟⲧⲁⲛ	ϩⲟⲧⲁⲛ
ϩⲟⲧⲁⲛ`	ϩⲟⲧⲁⲛ
ϩⲟⲧⲃⲉ	ϩⲟⲧⲃⲉ
ϩⲟⲧⲉ	ϩⲟⲧⲉ
ϩⲟⲧⲉ`	ϩⲟⲧⲉ
ϩⲟⲧⲡ	ϩⲟⲧⲡ
ϩⲟⲩⲉⲓⲧⲉ	ϩⲟⲩⲉⲓⲧⲉ
ϩⲟⲩⲛ̣	ϩⲟⲩⲛ
ϩⲟⲩⲛ	ϩⲟⲩⲛ
ϩⲟⲩⲛ	ϩⲟⲩⲛ
ϩⲟⲩⲟ̂	ϩⲟⲩⲟ
ϩⲟⲩⲟ̇	ϩⲟⲩⲟ
ϩⲟⲩⲟ⳿	ϩⲟⲩⲟ
ϩⲟⲩⲟ	ϩⲟⲩⲟ
ϩⲟⲩⲟ`	ϩⲟⲩⲟ
ϩⲟⲩ	ϩⲟⲩo
ϩⲟ	ϩⲟ
ϩⲣⲁⲓ̈	ϩⲣⲁⲓ
ϩⲣⲁⲓ̈	ϩⲣⲁⲓ
ϩⲣⲁⲓ	ϩⲣⲁⲓ
ϩⲣⲁⲭ̇ⲏⲗ	ϩⲣⲁⲭⲏⲗ
ϩⲣⲁⲭⲏⲗ`	ϩⲣⲁⲭⲏⲗ
ϩⲣⲉⲃⲉⲕⲕⲁ	ϩⲣⲉⲃⲉⲕⲕⲁ
ϩⲣⲉⲃⲉⲕⲕⲁ`	ϩⲣⲉⲃⲉⲕⲕⲁ
ϩⲣⲉ`	ϩⲣⲉ
ϩⲣⲟϣ	ϩⲣⲟϣ
ϩⲣⲟϣ`	ϩⲣⲟϣ
ϩⲣⲟⲟⲩ	ϩⲣⲟⲟⲩ
ϩⲣⲱ̂	ϩⲣⲱ
ϩⲣⲱ	ϩⲣⲱ
ϩⲧⲏ︤	ϩⲧⲏ
ϩⲧⲏ	ϩⲧⲏ
ϩⲧⲟ̂	ϩⲧⲟ
ϩⲨⲗⲏ	ϩⲩⲗⲏ
ϩⲩⲡⲁⲣⲭⲟⲛⲧⲁ`	ϩⲩⲡⲁⲣⲭⲟⲛⲧⲁ
ϩⲩⲡⲁⲣⲭⲟ⳯ⲧⲁ	ϩⲩⲡⲁⲣⲭⲟⲛⲧⲁ
ϩⲩⲡⲉⲣⲉⲭⲓ̇ⲟⲥ	ϩⲩⲡⲉⲣⲉⲭⲓⲟⲥ
ϩⲩⲡⲟⲕⲣⲓⲥⲓⲥ̣	ϩⲩⲡⲟⲕⲣⲓⲥⲓⲥ
ϩⲩⲡⲟⲕⲣⲓⲥⲓⲥ`	ϩⲩⲡⲟⲕⲣⲓⲥⲓⲥ
ϩⲩⲡⲟⲕⲣⲓⲧⲏⲥ`	ϩⲩⲡⲟⲕⲣⲓⲧⲏⲥ
ϩⲩⲡⲟⲙⲓ̇ⲛⲉ	ϩⲩⲡⲟⲙⲓⲛⲉ
ϩⲩⲡⲟⲙⲓⲛⲉ`	ϩⲩⲡⲟⲙⲓⲛⲉ
ϩⲩⲡⲟⲙⲟⲛⲏ	ϩⲩⲡⲟⲙⲟⲛⲏ
ϩⲩⲡⲟⲧⲁⲅⲏ	ϩⲩⲡⲟⲧⲁⲅⲏ
ϩⲩⲡⲟⲧⲁⲥⲥⲉ	ϩⲩⲡⲟⲧⲁⲥⲥⲉ
ϩⲱ̂	ϩⲱ
ϩⲱ̇ⲱ̇	ϩⲱⲱ
ϩⲱ̣ⲛ	ϩⲱⲛ
ϩⲱⲂ	ϩⲱⲃ
ϩⲱⲃ⳿	ϩⲱⲃ
ϩⲱⲃ︤ⲥ︥	ϩⲱⲃⲥ
ϩⲱⲃ	ϩⲱⲃ
ϩⲱⲃ`	ϩⲱⲃ
ϩⲱⲙ	ϩⲱⲙ
ϩⲱⲛ	ϩⲱⲛ
ϩⲱⲟⲩ`	ϩⲱⲟⲩ
ϩⲱⲡ⳿	ϩⲱⲡ
ϩⲱⲡ	ϩⲱⲡ
ϩⲱⲡ	ϩⲱⲡ
ϩⲱⲡ`	ϩⲱⲡ
ϩⲱⲡ`	ϩⲱⲡ
ϩⲱⲣ︤ⲡ︥	ϩⲱⲣⲡ
ϩⲱⲥⲟⲛ	ϩⲱⲥⲟⲛ
ϩⲱⲥⲧⲉ	ϩⲱⲥⲧⲉ
ϩⲱⲥⲧⲉ`	ϩⲱⲥⲧⲉ
ϩⲱⲥ⳿	ϩⲱⲥ
ϩⲱⲥ	ϩⲱⲥ
ϩⲱⲧ︤ⲡ︥	ϩⲱⲧⲡ
ϩⲱⲧ	ϩⲱⲧ
ϩⲱⲰ	ϩⲱⲱ
ϩⲱⲱ	ϩⲱⲱ
ϩⲱⲱ	ϩⲱⲱ
ϩⲱ	ϩⲱ
ϩⲱ	ϩⲱ
ϩ︤ⲗ̣︥[ⲗⲟ]	ϩⲗⲗⲟ
ϩ︤ⲗ︥ⲗⲟ	ϩⲗⲗⲟ
ϩ︤ⲗ︥ⲗⲟ`	ϩⲗⲗⲟ
ϩ︤ⲗ︥ⲗⲱ̂	ϩⲗⲗⲱ
ϩ︤ⲗ︥ⲗⲱ	ϩⲗⲗⲱ
ϩ︤ⲙ︥ϩⲁⲗ	ϩⲙϩⲁⲗ
ϩ︤ⲙ︥ϩⲁⲗ]	ϩⲙϩⲁⲗ
ϩ︤ⲙ︥ϩⲁⲗ`	ϩⲙϩⲁⲗ
ϩ︤ⲙ︥ϩ︤ⲙ︥	ϩⲙϩⲙ
ϩ︤ⲙ︥ⲟⲧ	ϩⲙⲟⲧ
ϩ︤ⲙ︥ⲟⲧ`	ϩⲙⲟⲧ
ϩ︤ⲙ︥	ϩⲙ
ϩ︤ⲛ̣︥	ϩⲛ
ϩ︤ⲛ︥ⲁ	ϩⲛⲁ
ϩ︤ⲛ︥	ϩⲛ
ϩ︥ⲗⲟⲡⲗ[ⲡ	ϩⲗⲟⲡⲗⲡ
ϩ︦ⲗ︥ⲗⲟ`	ϩⲗⲗⲟ
ϩ︦ⲙ︥ϩⲁⲗ	ϩⲙϩⲁⲗ
ϫ̇ⲛⲉ	ϫⲛⲉ
ϫ̇ⲛⲟⲩ	ϫⲛⲟⲩ
ϫ̇ⲡⲉ	ϫⲡⲉ
ϫ̇ⲡⲟ	ϫⲡⲟ
ϫ̣ⲉⲣⲟ	ϫⲉⲣⲟ
ϫ̣ⲓ̣	ϫⲓ
ϫ̣ⲓϩⲣⲁ̣ϥ	ϫⲓϩⲣⲁϥ
ϫ̣ⲓⲛ	ϫⲓⲛ
ϫ̣ⲡⲉ	ϫⲡⲉ
ϫ̣ⲱⲱⲙⲉ	ϫⲱⲱⲙⲉ
ϫ̣[ⲟⲉⲓⲥ]	ϫⲟⲉⲓⲥ
ϫⲁϩⲙ	ϫⲁϩⲙ
ϫⲁϫⲉ	ϫⲁϫⲉ
ϫⲁϫⲉ`	ϫⲁϫⲉ
ϫⲁⲓ̇ⲉ̇	ϫⲁⲓⲉ
ϫⲁⲓ̈ⲉ	ϫⲁⲓⲉ
ϫⲁⲥⲓϩⲏⲧ	ϫⲁⲥⲓϩⲏⲧ
ϫⲉ̇	ϫⲉ
ϫⲉⲕⲁⲥ	ϫⲉⲕⲁⲥ
ϫⲉⲕⲁⲥ`	ϫⲉⲕⲁⲥ
ϫⲉⲕ︤ⲙ︥	ϫⲉⲕⲙ
ϫⲉⲣⲟ̂	ϫⲉⲣⲟ
ϫⲉⲣⲱ	ϫⲉⲣⲱ
ϫⲉ	ϫⲉ
ϫⲉ	ϫⲉ
ϫⲉ`	ϫⲉ
ϫⲉ`	ϫⲉ
ϫⲏⲕ	ϫⲏⲕ
ϫⲏⲣ	ϫⲏⲣ
ϫⲓ̂	ϫⲓ
ϫⲓ̇ϣ̇ⲕⲁⲕ	ϫⲓϣⲕⲁⲕ
ϫⲓ̇ϫⲱⲓ	ϫⲓϫⲱⲓ
ϫⲓ̇ⲛ	ϫⲓⲛ
ϫⲓ̇ⲟⲩⲉ̇	ϫⲓⲟⲩⲉ
ϫⲓ̇ⲧ	ϫⲓⲧ
ϫⲓ̇	ϫⲓ
ϫⲓ̇	ϫⲓ
ϫⲓ̈	ϫⲓ
ϫⲓϥⲟϭ︤ⲥ︥	ϫⲓϥⲟϭⲥ
ϫⲓϩⲣⲁ	ϫⲓϩⲣⲁ
ϫⲓϫⲉⲉⲩⲉ`	ϫⲓϫⲉⲉⲩⲉ
ϫⲓϫⲉⲉⲩ`	ϫⲓϫⲉⲉⲩⲉ
ϫⲓⲕⲃⲁ	ϫⲓⲕⲃⲁ
ϫⲓⲕⲃⲁ	ϫⲓⲕⲃⲁ
ϫⲓⲙ̣	ϫⲓⲙ
ϫⲓⲛϫⲏ̂	ϫⲓⲛϫⲏ
ϫⲓⲛϫⲏ⳿	ϫⲓⲛϫⲏ
ϫⲓⲛϫⲏ	ϫⲓⲛϫⲏ
ϫⲓⲛϭⲟⲛ︤ⲥ︥	ϫⲓⲛϭⲟⲛⲥ
ϫⲓⲛ	ϫⲓⲛ
ϫⲓⲛ	ϫⲓⲛ
ϫⲓⲛ	ϫⲓⲛ
ϫⲓⲟⲩⲁ̂	ϫⲓⲟⲩⲁ
ϫⲓⲟⲩⲉ	ϫⲓⲟⲩⲉ
ϫⲓⲟⲩⲉ`	ϫⲓⲟⲩⲉ
ϫⲓⲥⲃⲱ	ϫⲓⲥⲃⲱ
ϫⲓⲥⲉ	ϫⲓⲥⲉ
ϫⲓⲥⲙⲟⲩ	ϫⲓⲥⲙⲟⲩ
ϫⲓⲧⲉ	ϫⲓⲧⲉ
ϫⲓⲧ︤	ϫⲓⲧ
ϫⲓⲧ	ϫⲓⲧ
ϫⲓ⳯	ϫⲓⲛ
ϫⲓ	ϫⲓ
ϫⲓ	ϫⲓ
ϫⲓ	ϫⲓ
ϫⲓ`	ϫⲓ
ϫⲓ`	ϫⲓ
ϫⲛ̄	ϫⲛ
ϫⲛⲁϩ	ϫⲛⲁϩ
ϫⲛⲉ	ϫⲛⲉ
ϫⲛⲟⲩ	ϫⲛⲟⲩ
ϫⲟ̂	ϫⲟ
ϫⲟⲉⲓ̇ⲥ	ϫⲟⲉⲓⲥ
ϫⲟⲉⲓ̈ⲥ	ϫⲟⲉⲓⲥ
ϫⲟⲉⲓⲥ	ϫⲟⲉⲓⲥ
ϫⲟⲉⲓⲥ`	ϫⲟⲉⲓⲥ
ϫⲟⲓ̈ⲥ	ϫⲟⲉⲓⲥ
ϫⲟⲓ̈	ϫⲟⲓ
ϫⲟⲕⲙ	ϫⲟⲕⲙ
ϫⲟⲛⲧ	ϫⲟⲛⲧ
ϫⲟⲞ	ϫⲟⲟ
ϫⲟⲟ̇ⲣ	ϫⲟⲟⲣ
ϫⲟⲟ̇	ϫⲟⲟ
ϫⲟⲟⲣ	ϫⲟⲟⲣ
ϫⲟⲟⲩ	ϫⲟⲟⲩ
ϫⲟⲟ	ϫⲟⲟ
ϫⲟⲡϫ︤ⲡ︥	ϫⲟⲡϫⲡ
ϫⲟⲥⲉ`	ϫⲟⲥⲉ
ϫⲟⲩⲧⲏ⳿	ϫⲟⲩⲧⲏ
ϫⲟ	ϫⲟ
ϫⲟ`	ϫⲟ
ϫⲡⲓⲟ̂	ϫⲡⲓⲟ
ϫⲡⲓⲟ	ϫⲡⲓⲟ
ϫⲡⲓⲟ`	ϫⲡⲓⲟ
ϫⲡⲟ̂	ϫⲡⲟ
ϫⲡⲟ	ϫⲡⲟ
ϫⲣ̣ⲟⲡ	ϫⲣⲟⲡ
ϫⲣⲟⲡ̂	ϫⲣⲟⲡ
ϫⲣⲟⲡ⳿	ϫⲣⲟⲡ
ϫⲣⲟⲡ	ϫⲣⲟⲡ
ϫⲱ̂	ϫⲱ
ϫⲱ̂`	ϫⲱ
ϫⲱϥ	ϫⲱϥ
ϫⲱϩⲙ̄	ϫⲱϩⲙ
ϫⲱϩⲙ︥	ϫⲱϩⲙ
ϫⲱϩ︤ⲙ︥	ϫⲱϩⲙ
ϫⲱϩ︤ⲙ︥	ϫⲱϩⲙ
ϫⲱϩ︤ⲙ︥`	ϫⲱϩⲙ
ϫⲱϩ	ϫⲱϩ
ϫⲱⲕ︤ⲙ︥	ϫⲱⲕⲙ
ϫⲱⲕ︤ⲙ︥	ϫⲱⲕⲙ
ϫⲱⲕ	ϫⲱⲕ
ϫⲱⲕ`	ϫⲱⲕ
ϫⲱⲧ︤ⲙ̣︥	ϫⲱⲧⲙ
ϫⲱⲱ̂ⲙⲉ⳿	ϫⲱⲱⲙⲉ
ϫⲱⲱ̇ⲙⲉ	ϫⲱⲱⲙⲉ
ϫⲱⲱⲙⲉ	ϫⲱⲱⲙⲉ
ϫⲱ⳿	ϫⲱ
ϫⲱ	ϫⲱ
ϫⲱ	ϫⲱ
ϫ︤ⲃ︥ⲃⲉⲥ⳿	ϫⲃⲃⲉⲥ
ϫ[ⲉ]	ϫ[ⲉ]
Ϭⲓ̇ϫ	ϭⲓϫ
ϭ̣ⲉ	ϭⲉ
ϭ̣ⲟⲙ`	ϭⲟⲙ
ϭⲁⲗⲱⲟⲩ	ϭⲁⲗⲱⲟⲩ
ϭⲁⲗⲱ	ϭⲁⲗⲱ
ϭⲉⲡⲏ̂	ϭⲉⲡⲏ
ϭⲉⲡⲏ	ϭⲉⲡⲏ
ϭⲉⲡⲏ	ϭⲉⲡⲏ
ϭⲉⲣⲱⲃ	ϭⲉⲣⲱⲃ
ϭⲉ	ϭⲉ
ϭⲉ	ϭⲉ
ϭⲉ`	ϭⲉ
ϭⲓ̇ϫ	ϭⲓϫ
ϭⲓ̇ⲛⲉ	ϭⲓⲛⲉ
ϭⲓϫ	ϭⲓϫ
ϭⲓⲛϣⲁϫⲉ	ϭⲓⲛϣⲁϫⲉ
ϭⲓⲛϣⲱⲗⲙ̄	ϭⲓⲛϣⲱⲗⲙ
ϭⲓⲛϭⲗⲱ	ϭⲓⲛϭⲗⲱ
ϭⲓⲛⲁϩⲉⲣⲁⲧ︤	ϭⲓⲛⲁϩⲉⲣⲁⲧ
ϭⲓⲛⲛⲁⲩ	ϭⲓⲛⲛⲁⲩ
ϭⲓⲛⲟⲩⲱⲙ⳿	ϭⲓⲛⲟⲩⲱⲙ
ϭⲓⲛⲥⲱⲧⲙ̇	ϭⲓⲛⲥⲱⲧⲙ
ϭⲙ̄ϭⲟⲙ	ϭⲙϭⲟⲙ
ϭⲙ̇ϭⲟⲙ̇	ϭⲙϭⲟⲙ
ϭⲛ̇ⲧ	ϭⲛⲧ
ϭⲛ̇	ϭⲛ
ϭⲟⲗⲡ̇	ϭⲟⲗⲡ
ϭⲟⲗ⳿	ϭⲟⲗ
ϭⲟⲗ	ϭⲟⲗ
ϭⲟⲗ`	ϭⲟⲗ
ϭⲟⲙ̣	ϭⲟⲙ
ϭⲟⲙ	ϭⲟⲙ
ϭⲟⲙ`	ϭⲟⲙ
ϭⲟⲛⲥ̄	ϭⲟⲛⲥ
ϭⲟⲛⲥ	ϭⲟⲛⲥ
ϭⲟⲛⲧ	ϭⲟⲛⲧ
ϭⲟⲛ︤ⲥ︥	ϭⲟⲛⲥ
ϭⲟⲟⲙ⳿	ϭⲟⲟⲙ
ϭⲟⲡ̇	ϭⲟⲡ
ϭⲟⲣϭⲥ̄︥	ϭⲟⲣϭⲥ
ϭⲟⲣϭⲥ	ϭⲟⲣϭⲥ
ϭⲟⲧⲡ	ϭⲟⲧⲡ
ϭⲟⲧ	ϭⲟⲧ
ϭⲱ̂	ϭⲱ
ϭⲱϣⲧ	ϭⲱϣⲧ
ϭⲱϣ︤ⲧ︥	ϭⲱϣⲧ
ϭⲱⲗⲡ̇	ϭⲱⲗⲡ
ϭⲱⲗⲡ̇	ϭⲱⲗⲡ
ϭⲱⲗ︤ⲡ︥	ϭⲱⲗⲡ
ϭⲱⲛⲧ̇	ϭⲱⲛⲧ
ϭⲱⲛⲧ︥	ϭⲱⲛⲧ
ϭⲱⲛⲧ	ϭⲱⲛⲧ
ϭⲱⲛ︤ⲧ︥	ϭⲱⲛⲧ
ϭⲱⲛ︤ⲧ︥	ϭⲱⲛⲧ
ϭⲱ	ϭⲱ
ϭ︤ⲙ︥ϭⲟⲙ	ϭⲙϭⲟⲙ
ϭ︤ⲛ︥ⲉⲓⲇⲱⲗⲟⲛ⳿	ϭⲛⲉⲓⲇⲱⲗⲟⲛ
ϭ︤ⲛ︥	ϭⲛ
ϯ̇̇ϩⲏⲩ	ϯϩⲏⲩ
ϯ̇ϩⲏⲩ	ϯϩⲏⲩ
ϯ̇ϩⲓ̈ⲥⲉ	ϯϩⲓⲥⲉ
ϯ̇ⲙⲏ	ϯⲙⲏ
ϯ̇ⲛ̇ⲧⲟⲗⲏ	ϯⲛⲧⲟⲗⲏ
ϯ̇	ϯ
ϯ̇	ϯ
ϯ̣	ϯ
ϯϩⲏⲩ	ϯϩⲏⲩ
ϯⲉⲟⲟⲩ	ϯⲉⲟⲟⲩ
ϯⲙⲉ⳿	ϯⲙⲉ
ϯⲛⲟⲩϭ︤ⲥ︥	ϯⲛⲟⲩϭⲥ
ϯⲟⲥⲉ	ϯⲟⲥⲉ
ϯⲟⲩⲱ̇	ϯⲟⲩⲱ
ϯⲡ̣ⲓ̣	ϯⲡⲓ
ϯⲥⲃⲱ̂	ϯⲥⲃⲱ
ϯⲥⲃⲱ	ϯⲥⲃⲱ
ϯⲥⲙⲏ⳿	ϯⲥⲙⲏ
ϯⲧⲱⲛ⳿	ϯⲧⲱⲛ
ϯⲧⲱⲛ	ϯⲧⲱⲛ
ϯⲧⲱⲛ	ϯⲧⲱⲛ
ϯ	ϯ
ϯ	ϯ
ϯ	ⲓ
ϯ	ϯ
…ⲛ	…ⲛ
Ⲁ̇ⲛⲟⲛ	ⲁⲛⲟⲛ
Ⲁ̣ⲩⲱ	ⲁⲩⲱ
Ⲁϣ	ⲁϣ
Ⲁϩⲣⲟ	ⲁϩⲣⲟ
Ⲁⲃⲣⲁϩⲁⲙ`	ⲁⲃⲣⲁϩⲁⲙ
Ⲁⲗⲗⲁ	ⲁⲗⲗⲁ
Ⲁⲛⲟⲕ	ⲁⲛⲟⲕ
Ⲁⲛⲟⲛ	ⲁⲛⲟⲛ
Ⲁⲛⲟⲛ`	ⲁⲛⲟⲛ
Ⲁⲛ	ⲁⲛ
Ⲁⲧϩⲏⲧ	ⲁⲧϩⲏⲧ
Ⲁⲩⲱ̇	ⲁⲩⲱ
Ⲁⲩⲱ	ⲁⲩⲱ
Ⲁⲩⲱ	ⲁⲩⲱ
Ⲁ	ⲁ
ⲁ̇ϣ	ⲁϣ
ⲁ̇ϩⲉⲣⲁⲧ̇	ⲁϩⲉⲣⲁⲧ
ⲁ̇ϩⲉⲣⲁⲧ	ⲁϩⲉⲣⲁⲧ
ⲁ̇ϫⲓ̇̇	ⲁϫⲓ
ⲁ̇ϫⲓ̇	ⲁϫⲓ
ⲁ̇ϫⲙ̇	ⲁϫⲙ
ⲁ̇ⲁ	ⲁⲁ
ⲁ̇ⲅⲁⲑⲟⲛ	ⲁⲅⲁⲑⲟⲛ
ⲁ̇ⲅⲅⲏⲛ	ⲁⲅⲅⲏⲛ
ⲁ̇ⲅⲱⲛⲓ̇ⲍⲉ	ⲁⲅⲱⲛⲓⲍⲉ
ⲁ̇ⲙⲁϩⲧⲉ	ⲁⲙⲁϩⲧⲉ
ⲁ̇ⲙⲏⲓ̇	ⲁⲙⲏⲓ
ⲁ̇ⲛϫⲱϫ	ⲁⲛϫⲱϫ
ⲁ̇ⲛⲟⲕ	ⲁⲛⲟⲕ
ⲁ̇ⲛⲟⲛ	ⲁⲛⲟⲛ
ⲁ̇ⲛⲧⲱⲛⲓ̇ⲟⲥ	ⲁⲛⲧⲱⲛⲓⲟⲥ
ⲁ̇ⲛ	ⲁⲛ
ⲁ̇ⲡⲁⲛⲧⲁ	ⲁⲡⲁⲛⲧⲁ
ⲁ̇ⲡⲁ	ⲁⲡⲁ
ⲁ̇ⲡⲟⲧⲁⲥⲥⲉ	ⲁⲡⲟⲧⲁⲥⲥⲉ
ⲁ̇ⲡⲟⲧ	ⲁⲡⲟⲧ
ⲁ̇ⲣⲓ̈	ⲁⲣⲓ
ⲁ̇ⲥⲕⲏⲥⲓⲥ	ⲁⲥⲕⲏⲥⲓⲥ
ⲁ̇ⲧⲟⲩⲱ̇	ⲁⲧⲟⲩⲱ
ⲁ̇ⲩⲝⲁⲛⲉ	ⲁⲩⲝⲁⲛⲉ
ⲁ̇ⲩⲱ̇	ⲁⲩⲱ
ⲁ̇	ⲁ
ⲁ̣ϣ̣	ⲁϣ
ⲁ̣ⲗ̣ⲟⲙ̣	ⲁⲗⲟⲙ
ⲁ̣ⲛⲁⲅ̣ⲕⲁⲓⲟⲛ	ⲁⲛⲁⲅⲕⲁⲓⲟⲛ
ⲁ̣ⲛ	ⲁⲛ
ⲁ̣ⲣⲁ̣	ⲁⲣⲁ
ⲁ̣ⲩⲱ	ⲁⲩⲱ
ⲁ̣[	ⲁ
ⲁϣ̣	ⲁϣ
ⲁϣⲁⲓ̈	ⲁϣⲁⲓ
ⲁϣⲏ	ⲁϣⲏ
ⲁϣⲱ	ⲁϣⲱ
ⲁϣ	ⲁϣ
ⲁϣ	ⲁϣ
ⲁϣ	ⲁϣϣⲕⲁⲕ
ⲁϥ̂	ⲁϥ
ⲁϩⲉⲣⲁⲧ︤	ⲁϩⲉⲣⲁⲧ
ⲁϩⲉⲣⲁⲧ	ⲁϩⲉⲣⲁⲧ
ⲁϩⲟ̂	ⲁϩⲟ
ⲁϫⲓ	ⲁϫⲓ
ⲁϫ︤ⲙ︥	ⲁϫⲙ
ⲁϫ︤ⲛ︥	ⲁϫⲛ
ⲁϭⲟⲗⲧⲉ⳿	ⲁϭⲟⲗⲧⲉ
ⲁϭⲟⲗⲧⲉ	ⲁϭⲟⲗⲧⲉ
ⲁϭⲣⲏⲛ	ⲁϭⲣⲏⲛ
ⲁⲁ	ⲁⲁ
ⲁⲃⲉⲗ	ⲁⲃⲉⲗ
ⲁⲃⲣⲁϩⲁⲙ	ⲁⲃⲣⲁϩⲁⲙ
ⲁⲃⲣⲁϩⲁⲙ`	ⲁⲃⲣⲁϩⲁⲙ
ⲁⲅⲁⲑ̣ⲁⲣⲥⲓ	ⲁⲅⲁⲑⲁⲣⲥⲓ
ⲁⲅⲁⲑⲟⲛ	ⲁⲅⲁⲑⲟⲛ
ⲁⲅⲁⲑⲟⲛ`	ⲁⲅⲁⲑⲟⲛ
ⲁⲅⲁⲑⲟⲥ	ⲁⲅⲁⲑⲟⲥ
ⲁⲅⲁⲡⲏ	ⲁⲅⲁⲡⲏ
ⲁⲅⲅⲉⲗⲓⲟⲛ	ⲁⲅⲅⲉⲗⲓⲟⲛ
ⲁⲅⲅⲉⲗⲟⲥ	ⲁⲅⲅⲉⲗⲟⲥ
ⲁⲅⲅⲉⲗⲟⲥ`	ⲁⲅⲅⲉⲗⲟⲥ
ⲁⲅⲅⲓⲟⲛ	ⲁⲅⲅⲓⲟⲛ
ⲁⲅⲱⲣⲁ	ⲁⲅⲱⲣⲁ
ⲁⲇ̣ⲓⲕ̣ⲟⲥ	ⲁⲇⲓⲕⲟⲥ
ⲁⲏ`	ϩⲁⲏ
ⲁⲑⲉⲧⲓ̂	ⲁⲑⲉⲧⲓ
ⲁⲑⲉⲧⲓ	ⲁⲑⲉⲧⲓ
ⲁⲑⲉⲧⲓ`	ⲁⲑⲉⲧⲓ
ⲁⲑⲏⲧ	ⲁⲑⲏⲧ
ⲁⲓ̇ⲥ̇ⲑⲁⲛⲉ	ⲁⲓⲥⲑⲁⲛⲉ
ⲁⲓ̇	ⲁⲓ
ⲁⲓ̈ⲱⲛ	ⲁⲓⲱⲛ
ⲁⲓⲥⲑⲁⲛⲉ`	ⲁⲓⲥⲑⲁⲛⲉ
ⲁⲓⲥⲑⲏⲥⲓⲥ	ⲁⲓⲥⲑⲏⲥⲓⲥ
ⲁⲓⲧⲉⲓ̈	ⲁⲓⲧⲉⲓ
ⲁⲓⲧⲏⲙⲁ	ⲁⲓⲧⲏⲙⲁ
ⲁⲓⲱⲛ	ⲁⲓⲱⲛ
ⲁⲕⲁⲑⲁⲣⲥⲓⲁ	ⲁⲕⲁⲑⲁⲣⲥⲓⲁ
ⲁⲕⲁⲑⲁⲣⲧⲟⲥ`	ⲁⲕⲁⲑⲁⲣⲧⲟⲥ
ⲁⲗⲁⲥⲥⲁ	ϩⲁⲗⲁⲥⲥⲁ
ⲁⲗⲉⲝⲁⲛⲇⲣⲟⲥ	ⲁⲗⲉⲝⲁⲛⲇⲣⲟⲥ
ⲁⲗⲖⲁ	ⲁⲗⲗⲁ
ⲁⲗⲗⲁ	ⲁⲗⲗⲁ
ⲁⲗⲗⲁ`	ⲁⲗⲗⲁ
ⲁⲙ̇ⲁϩⲧⲉ	ⲁⲙⲁϩⲧⲉ
ⲁⲙⲁϩⲧⲉ	ⲁⲙⲁϩⲧⲉ
ⲁⲙⲟⲩ	ⲁⲙⲟⲩ
ⲁⲙ︤ⲛ︦ⲧ︥ⲉ	ⲁⲙⲛⲧⲉ
ⲁⲛ̀	ⲁⲛ
ⲁⲛ̣ⲉⲭⲉ	ⲁⲛⲉⲭⲉ
ⲁⲛ̣	ⲁⲛ
ⲁⲛϫⲱϫ	ⲁⲛϫⲱϫ
ⲁⲛⲁϣ	ⲁⲛⲁϣ
ⲁⲛⲁϥ`	ⲁⲛⲁϥ
ⲁⲛⲁⲅⲕ̣ⲏ̣	ⲁⲛⲁⲅⲕⲏ
ⲁⲛⲁⲅⲕⲁⲍⲉ⳿	ⲁⲛⲁⲅⲕⲁⲍⲉ
ⲁⲛⲁⲅⲕⲁⲍⲉ	ⲁⲛⲁⲅⲕⲁⲍⲉ
ⲁⲛⲁⲅⲕⲁⲓⲟⲛ	ⲁⲛⲁⲅⲕⲁⲓⲟⲛ
ⲁⲛⲁⲅⲕⲏ	ⲁⲛⲁⲅⲕⲏ
ⲁⲛⲁⲩ	ⲁⲛⲁⲩ
ⲁⲛⲁ[ϥ]	ⲁⲛⲁϥ
ⲁⲛⲉⲭⲉ⳿	ⲁⲛⲉⲭⲉ
ⲁⲛⲍⲏⲃⲉ	ⲁⲛⲍⲏⲃⲉ
ⲁⲛⲛⲁ`	ⲁⲛⲛⲁ
ⲁⲛⲟⲕ	ⲁⲛⲟⲕ
ⲁⲛⲟⲕ`	ⲁⲛⲟⲕ
ⲁⲛⲟⲙⲓⲁ	ⲁⲛⲟⲙⲓⲁ
ⲁⲛⲟⲙⲓⲁ`	ⲁⲛⲟⲙⲓⲁ
ⲁⲛⲟⲙⲟⲥ⳿	ⲁⲛⲟⲙⲟⲥ
ⲁⲛⲟⲙⲟⲥ	ⲁⲛⲟⲙⲟⲥ
ⲁⲛⲟⲛ⳿	ⲁⲛⲟⲛ
ⲁⲛⲟⲛ	ⲁⲛⲟⲛ
ⲁⲛⲟⲛ`	ⲁⲛⲟⲛ
ⲁⲛⲟ⳯	ⲁⲛⲟⲛ
ⲁⲛⲧⲓⲭⲣⲓⲥⲧⲟⲥ	ⲁⲛⲧⲓⲭⲣⲓⲥⲧⲟⲥ
ⲁⲛ⳿	ⲁⲛ
ⲁⲛ︤ⲅ︥	ⲁⲛⲅ
ⲁⲛ	ⲁⲛ
ⲁⲛ`	ⲁⲛ
ⲁⲡ̣ⲉⲭⲉ	ⲁⲡⲉⲭⲉ
ⲁⲡⲁⲧⲁ⳿	ⲁⲡⲁⲧⲁ
ⲁⲡⲁ	ⲁⲡⲁ
ⲁⲡⲉⲓⲗⲉⲓ⳿	ⲁⲡⲉⲓⲗⲉⲓ
ⲁⲡⲉ`	ⲁⲡⲉ
ⲁⲡⲟⲗⲁⲩⲥⲓⲥ⳿	ⲁⲡⲟⲗⲁⲩⲥⲓⲥ
ⲁⲡⲟⲥⲧⲁⲧⲏⲥ	ⲁⲡⲟⲥⲧⲁⲧⲏⲥ
ⲁⲡⲟⲥⲧⲟⲗⲟⲥ	ⲁⲡⲟⲥⲧⲟⲗⲟⲥ
ⲁⲡⲟⲥⲧⲟⲗⲟⲥ`	ⲁⲡⲟⲥⲧⲟⲗⲟⲥ
ⲁⲡⲟⲧⲁⲥⲥⲉ	ⲁⲡⲟⲧⲁⲥⲥⲉ
ⲁⲡⲟⲧⲁⲥⲥⲉ`	ⲁⲡⲟⲧⲁⲥⲥⲉ
ⲁⲡⲟⲫⲁⲥⲓⲥ	ⲁⲡⲟⲫⲁⲥⲓⲥ
ⲁⲣⲁ	ⲁⲣⲁ
ⲁⲣⲏϫ︤	ⲁⲣⲏϫ
ⲁⲣⲏϫ︤	ⲁⲣⲏϫ
ⲁⲣⲏⲩ	ⲁⲣⲏⲩ
ⲁⲣⲓⲕⲉ	ⲁⲣⲓⲕⲉ
ⲁⲣⲓⲕⲉ`	ⲁⲣⲓⲕⲉ
ⲁⲣⲟⲟⲩⲉ⳿	ⲁⲣⲟⲟⲩⲉ
ⲁⲣⲭⲁⲓⲟⲥ	ⲁⲣⲭⲁⲓⲟⲥ
ⲁⲣⲭⲁⲓⲟⲥ`	ⲁⲣⲭⲁⲓⲟⲥ
ⲁⲣⲭⲉⲓ`	ⲁⲣⲭⲉⲓ
ⲁⲣⲭⲏ̂	ⲁⲣⲭⲏ
ⲁⲣⲭⲏⲉ̇ⲡⲓ̇ⲥⲕⲟⲡⲟⲥ	ⲁⲣⲭⲏⲉⲡⲓⲥⲕⲟⲡⲟⲥ
ⲁⲣⲭⲏⲉⲡⲓⲥⲕⲟⲡⲟⲥ	ⲁⲣⲭⲏⲉⲡⲓⲥⲕⲟⲡⲟⲥ
ⲁⲣⲭⲏⲗⲏⲥⲧⲏⲥ	ⲁⲣⲭⲏⲗⲏⲥⲧⲏⲥ
ⲁⲣⲭⲏ	ⲁⲣⲭⲏ
ⲁⲣⲭⲱⲛ	ⲁⲣⲭⲱⲛ
ⲁⲣ	ⲁⲣ
ⲁⲥⲟⲩ	ⲁⲥⲟⲩ
ⲁⲧϣⲁⲩ	ⲁⲧϣⲁⲩ
ⲁⲧϩⲏⲧ	ⲁⲧϩⲏⲧ
ⲁⲧⲛⲁϩⲧⲉ	ⲁⲧⲛⲁϩⲧⲉ
ⲁⲧⲛⲁ⳿	ⲁⲧⲛⲁ
ⲁⲧⲛⲟⲩⲧⲉ	ⲁⲧⲛⲟⲩⲧⲉ
ⲁⲧⲛⲟⲩⲧⲉ`	ⲁⲧⲛⲟⲩⲧⲉ
ⲁⲧⲥⲃⲱ̂	ⲁⲧⲥⲃⲱ
ⲁⲧⲥⲟⲟⲩⲛ	ⲁⲧⲥⲟⲟⲩⲛ
ⲁⲧⲥⲟⲟⲩⲛ`	ⲙⲛⲧⲁⲧⲥⲟⲟⲩⲛ
ⲁⲧⲥⲱⲧⲙ̄`	ⲁⲧⲥⲱⲧⲙ
ⲁⲧⲥⲱⲧⲙ	ⲁⲧⲥⲱⲧⲙ
ⲁⲧⲥⲱⲧ︤ⲙ︥	ⲁⲧⲥⲱⲧⲙ
ⲁⲧⲧⲁⲕⲟ	ⲁⲧⲧⲁⲕⲟ
ⲁⲧ︤ⲙ︥ⲡϣⲁ`	ⲁⲧⲙⲡϣⲁ
ⲁⲩ̣ⲱ̣	ⲁⲩⲱ
ⲁⲩⲉⲧ	ⲁⲩⲉⲧ
ⲁⲩⲝⲁⲛⲉ`	ⲁⲩⲝⲁⲛⲉ
ⲁⲩⲧⲟⲩ`	ⲁⲩⲧⲟⲩ
ⲁⲩⲱ̄	ⲁⲩⲱ
ⲁⲩⲱ̇	ⲁⲩⲱ
ⲁⲩⲱ	ⲁⲩⲱ
ⲁⲩ	ⲁⲩ
ⲁⲩ[ⲩ]ⲱ	ⲁⲩⲱ
ⲁⲩ[ⲱ	ⲁⲩⲱ
ⲁⲫⲑⲟⲛⲓⲁ	ⲁⲫⲑⲟⲛⲓⲁ
ⲁⲫⲟⲣⲙⲏ⳿	ⲁⲫⲟⲣⲙⲏ
ⲁ︤	ⲁ
ⲁ	ⲁ
ⲁ	ⲁ
ⲁ	ⲛⲁ
ⲁ	ⲁ
ⲁ	ⲁ
ⲁ[ⲛ̣]	ⲁⲛ
ⲁ[ⲡⲟⲥ]ⲧⲟⲗⲟⲥ	ⲁⲡⲟⲥⲧⲟⲗⲟⲥ
ⲃ̄ⲗⲗⲏ̂	ⲃⲗⲗⲏ
ⲃϣⲉ`	ⲃϣⲉ
ⲃⲁϣⲟⲣ⳿	ⲃⲁϣⲟⲣ
ⲃⲁⲃⲉ̂	ⲃⲁⲃⲉ
ⲃⲁⲃⲉ⳿ⲣⲱⲙⲉ	ⲃⲁⲃⲉⲣⲱⲙⲉ
ⲃⲁⲗⲗⲁⲧⲓ̇ⲟⲛ	ⲃⲁⲗⲗⲁⲧⲓⲟⲛ
ⲃⲁⲗⲗⲁ	ⲃⲁⲗⲗⲁ
ⲃⲁⲗ	ⲃⲁⲗ
ⲃⲁⲗ`	ⲃⲁⲗ
ⲃⲁⲣⲁⲭⲓⲁⲥ	ⲃⲁⲣⲁⲭⲓⲁⲥ
ⲃⲁⲣⲃⲁⲣⲟⲥ⳿	ⲃⲁⲣⲃⲁⲣⲟⲥ
ⲃⲁⲣⲃⲁⲣⲟⲥ	ⲃⲁⲣⲃⲁⲣⲟⲥ
ⲃⲁⲣⲟⲥ⳿	ⲃⲁⲣⲟⲥ
ⲃⲁⲣⲟⲥ	ⲃⲁⲣⲟⲥ
ⲃⲁⲥⲓ̇ⲙⲟⲥ	ⲃⲁⲥⲓⲙⲟⲥ
ⲃⲁⲥⲕⲁⲛⲟⲥ	ⲃⲁⲥⲕⲁⲛⲟⲥ
ⲃⲁⲩⲕⲁⲗⲓⲟⲛ`	ⲃⲁⲩⲕⲁⲗⲓⲟⲛ
ⲃⲉⲉⲗⲍⲉⲃⲟⲩⲗ`	ⲃⲉⲉⲗⲍⲉⲃⲟⲩⲗ
ⲃⲉⲕⲉ	ⲃⲉⲕⲉ
ⲃⲉⲛⲓ̇ⲁ̇ⲙⲓ̇ⲛ	ⲃⲉⲛⲓⲁⲙⲓⲛ
ⲃⲉⲛⲓⲁⲙⲓⲛ`	ⲃⲉⲛⲓⲁⲙⲓⲛ
ⲃⲏⲙⲁ	ⲃⲏⲙⲁ
ⲃⲏⲥⲁⲣⲓ̈ⲟⲛ	ⲃⲏⲥⲁⲣⲓⲟⲛ
ⲃⲏⲥⲁⲣⲓⲟⲛ	ⲃⲏⲥⲁⲣⲓⲟⲛ
ⲃⲓⲟⲥ	ⲃⲓⲟⲥ
ⲃⲓⲟⲥ`	ⲃⲓⲟⲥ
ⲃⲛ︤ⲧ︥	ⲃⲛⲧ
ⲃⲟⲏⲑⲓⲁ⳿	ⲃⲟⲏⲑⲓⲁ
ⲃⲟⲏⲑⲟⲥ	ⲃⲟⲏⲑⲟⲥ
ⲃⲟⲗⲃ︤ⲗ︥	ⲃⲟⲗⲃⲗ
ⲃⲟⲗ	ⲃⲟⲗ
ⲃⲟⲟⲛⲉ	ⲃⲟⲟⲛⲉ
ⲃⲟⲧⲉ	ⲃⲟⲧⲉ
ⲃⲱⲕ⳿	ⲃⲱⲕ
ⲃⲱⲕ	ⲃⲱⲕ
ⲃⲱⲕ`	ⲃⲱⲕ
ⲃⲱⲗ	ⲃⲱⲗ
ⲃⲱⲗ	ⲃⲱⲗ
ⲃⲱⲗ`	ⲃⲱⲗ
ⲃⲱ	ⲃⲱ
ⲃ︤ⲗ︥ⲗⲉ	ⲃⲗⲗⲉ
ⲃ︤ⲣ︥ⲣⲉ⳿	ⲃⲣⲣⲉ
ⲃ︥ⲥⲱ	ϩⲃⲥⲱ
Ⲅⲁⲣ	ⲅⲁⲣ
ⲅ̇	ⲅ
ⲅⲁⲙⲟⲥ	ⲅⲁⲙⲟⲥ
ⲅⲁⲣ	ⲅⲁⲣ
ⲅⲁⲣ`	ⲅⲁⲣ
ⲅⲣⲁⲙⲙⲁⲧⲉⲩⲥ⳿	ⲅⲣⲁⲙⲙⲁⲧⲉⲩⲥ
ⲅⲣⲁⲪⲏ`	ⲅⲣⲁⲫⲏ
ⲅⲣⲁⲫⲏ̂	ⲅⲣⲁⲫⲏ
ⲅⲣⲁⲫⲏ̂`	ⲅⲣⲁⲫⲏ
ⲅⲣⲁⲫⲏ̇	ⲅⲣⲁⲫⲏ
ⲅⲣⲁⲫⲏ	ⲅⲣⲁⲫⲏ
ⲅⲣⲁⲫⲏ`	ⲅⲣⲁⲫⲏ
ⲅ︥	ⲅ
ⲅ︥	ⲅ
Ⲇⲉ̇	ⲇⲉ
Ⲇⲉ	ⲇⲉ
ⲇ̣ⲉ	ⲇⲉ
ⲇ̣ⲓ̣ⲕ̣[ⲁⲓⲟⲥ	ⲇⲓⲕⲁⲓⲟⲥ
ⲇⲁⲓⲙⲱⲛ⳿	ⲇⲁⲓⲙⲱⲛ
ⲇⲁⲓⲙⲱⲛ	ⲇⲁⲓⲙⲱⲛ
ⲇⲁⲩⲉⲓⲇ	ⲇⲁⲩⲉⲓⲇ
ⲇⲉ̇	ⲇⲉ
ⲇⲉⲃⲃⲱⲣⲁ`	ⲇⲉⲃⲃⲱⲣⲁ
ⲇⲉ	ⲇⲉ
ⲇⲉ`	ⲇⲉ
ⲇⲓⲁⲃⲟⲗⲟⲥ⳿	ⲇⲓⲁⲃⲟⲗⲟⲥ
ⲇⲓⲁⲃⲟⲗⲟⲥ	ⲇⲓⲁⲃⲟⲗⲟⲥ
ⲇⲓⲁⲃⲟⲗⲟⲥ	ⲇⲓⲁⲃⲟⲗⲟⲥ
ⲇⲓⲁⲑⲏⲕⲏ`	ⲇⲓⲁⲑⲏⲕⲏ
ⲇⲓⲁⲕⲟⲛⲓⲁ	ⲇⲓⲁⲕⲟⲛⲓⲁ
ⲇⲓⲁⲕⲟⲛⲓⲁ`	ⲇⲓⲁⲕⲟⲛⲓⲁ
ⲇⲓⲕⲁⲓⲟⲛ	ⲇⲓⲕⲁⲓⲟⲛ
ⲇⲓⲕⲁⲓⲟⲥⲩⲛⲏ̂`	ⲇⲓⲕⲁⲓⲟⲥⲩⲛⲏ
ⲇⲓⲕⲁⲓⲟⲥⲩⲛⲏ	ⲇⲓⲕⲁⲓⲟⲥⲩⲛⲏ
ⲇⲓⲕⲁⲓⲟⲥⲩⲛⲏ`	ⲇⲓⲕⲁⲓⲟⲥⲩⲛⲏ
ⲇⲓⲕⲁⲓⲟⲥ	ⲇⲓⲕⲁⲓⲟⲥ
ⲇⲓⲕⲁⲓⲟⲥ`	ⲇⲓⲕⲁⲓⲟⲥ
ⲇⲓⲱⲅⲙⲟⲥ	ⲇⲓⲱⲅⲙⲟⲥ
ⲇⲟⲇⲏⲥ	ⲇⲟⲇⲏⲥ
ⲇⲟⲩⲗⲟⲥ	ⲇⲟⲩⲗⲟⲥ
Ⲉϣϫⲉ	ⲉϣϫⲉ
Ⲉϣⲱⲡⲉ`	ⲉϣⲱⲡⲉ
Ⲉⲓⲧⲉ	ⲉⲓⲧⲉ
Ⲉⲕϣⲁⲛ	ⲉⲕϣⲁⲛ
Ⲉⲛϣⲁⲛ	ⲉⲛϣⲁⲛ
Ⲉⲛⲉ	ⲉⲛⲉ
Ⲉⲡⲉⲓⲇⲏ	ⲉⲡⲉⲓⲇⲏ
Ⲉⲡⲉⲓⲇⲏ`	ⲉⲡⲉⲓⲇⲏ
Ⲉⲣϣⲁⲛ	ⲉⲣϣⲁⲛ
Ⲉⲣⲉ	ⲉⲣⲉ
Ⲉⲧⲃⲉ	ⲉⲧⲃⲉ
Ⲉⲩⲉ	ⲉⲩⲉ
Ⲉ︤	ⲉ
Ⲉ	ⲉ
Ⲉ	ⲉ
ⲉ̂[ⲧ	ⲉⲧ
ⲉ̄	ⲉ
ⲉ̇ϣⲱⲡⲉ	ⲉϣⲱⲡⲉ
ⲉ̇ϩⲟⲩⲛ	ⲉϩⲟⲩⲛ
ⲉ̇ϩⲣⲁⲓ	ⲉϩⲣⲁⲓ
ⲉ̇ϫⲛ	ⲉϫⲛ
ⲉ̇ϫⲱ	ⲉϫⲱ
ⲉ̇ⲂⲟⲖ	ⲉⲃⲟⲗ
ⲉ̇ⲃⲟⲗ	ⲉⲃⲟⲗ
ⲉ̇ⲑ	ⲉⲧ
ⲉ̇ⲛⲉϩ	ⲉⲛⲉϩ
ⲉ̇ⲛⲉⲣⲅⲓⲁ	ⲉⲛⲉⲣⲅⲓⲁ
ⲉ̇ⲣϣⲁⲛ	ⲉⲣϣⲁⲛ
ⲉ̇ⲣϣⲁⲛ	ⲉⲣϣⲁⲛ
ⲉ̇ⲣⲉ	ⲉⲣⲉ
ⲉ̇ⲣⲉ	ⲉⲣⲉ
ⲉ̇ⲣⲟ	ⲉⲣⲟ
ⲉ̇ⲧ̇ⲃⲉ	ⲉⲧⲃⲉ
ⲉ̇ⲧⲃⲉ	ⲉⲧⲃⲉ
ⲉ̇ⲧⲉ	ⲉⲧⲉ
ⲉ̇ⲧ	ⲉⲧ
ⲉ̇ⲧ 	ⲉⲧ
ⲉ̇ⲩⲉ	ⲉⲩⲉ
ⲉ̇Ⲫⲣⲉⲙ	ⲉⲫⲣⲉⲙ
ⲉ̇	ⲉ
ⲉ̇	ⲉ
ⲉ̇	ⲉ
ⲉ̇	ⲉ
ⲉ̇	ⲉ
ⲉ̇	ϩⲉ
ⲉ̇	ⲉ
ⲉ̣ⲣ̣ⲟ	ⲉⲣⲟ
ⲉ̣ⲣⲟ	ⲉⲣⲟ
ⲉ̣ⲧ̣	ⲉⲧ
ⲉ̣ⲧ	ⲉⲧ
ⲉ̣	ⲉ
ⲉ̣	ⲉ
ⲉ̣	ⲉ
ⲉ̣[.....]	ⲉ[.....]
ⲉϣϣⲉ	ⲉϣϣⲉ
ⲉϣϪⲉ	ⲉϣϫⲉ
ⲉϣϫⲉ	ⲉϣϫⲉ
ⲉϣϫⲉ`	ⲉϣϫⲉ
ⲉϣⲗⲟⲩⲗⲁⲓ̈	ⲉϣⲗⲟⲩⲗⲁⲓ
ⲉϣⲱⲡⲉ	ⲉϣⲱⲡⲉ
ⲉϣ	ⲉϣϣⲉ
ⲉϥϣⲁⲛ	ⲉϥϣⲁⲛ
ⲉϥⲉ	ⲉϥⲉ
ⲉϥⲓ	ⲉϥⲓ
ⲉϥ	ⲉϥ
ⲉϥ	ⲉϥ
ⲉϩ̣ⲣⲁⲓ	ⲉϩⲣⲁⲓ
ⲉϩⲉ⳿	ⲉϩⲉ
ⲉϩⲟⲟⲩ	ⲉϩⲟⲟⲩ
ⲉϩⲟⲩⲉ	ⲉϩⲟⲩⲉ
ⲉϩⲟⲩⲉ	ⲉϩⲟⲩⲉ
ⲉϩⲟⲩⲉ	ⲉϩⲟⲩⲉ
ⲉϩⲟⲩⲛ⳿	ⲉϩⲟⲩⲛ
ⲉϩⲟⲩⲛ	ⲉϩⲟⲩⲛ
ⲉϩⲟⲩⲛ`	ⲉϩⲟⲩⲛ
ⲉϩⲟⲩⲻ	ⲉϩⲟⲩⲛ
ⲉϩⲟⲩ⳯⳿	ⲉϩⲟⲩⲛ
ⲉϩⲟⲩ⳯	ⲉϩⲟⲩⲛ
ⲉϩⲣ̣[ⲁⲓ]	ⲉϩⲣⲁⲓ
ⲉϩⲣⲁ̣ⲓ̣̈	ⲉϩⲣⲁⲓ
ⲉϩⲣⲁⲓ̈	ⲉϩⲣⲁⲓ
ⲉϩⲣⲁⲓ	ⲉϩⲣⲁⲓ
ⲉϩⲣⲁ	ⲉϩⲣⲁ
ⲉϩⲣⲛ̣̄	ⲉϩⲣⲛ
ⲉϩ[ⲣⲁⲓ]	ⲉϩⲣⲁⲓ
ⲉϫⲏⲩ	ⲉϫⲏⲩ
ⲉϫⲙ̇	ⲉϫⲙ
ⲉϫⲙ̣	ⲉϫⲙ
ⲉϫⲙ	ⲉϫⲙ
ⲉϫⲛ̄	ⲉϫⲛ
ⲉϫⲛ	ⲉϫⲛ
ⲉϫⲱ̂	ⲉϫⲱ
ⲉϫⲱ	ⲉϫⲱ
ⲉϫⲱ	ⲉϫⲱ
ⲉϫ︤ⲙ︥	ⲉϫⲙ
ⲉϫ︤ⲛ︥	ⲉϫⲛ
ⲉϫ[.....]	ⲉϫ[.....]
ⲉ‴ⲧ	ⲉⲧ
ⲉⲃⲟ̣[ⲗ]	ⲉⲃⲟⲗ
ⲉⲃⲟⲗ⳿	ⲉⲃⲟⲗ
ⲉⲃⲟⲗ	ⲉⲃⲟⲗ
ⲉⲃⲟⲗ]	ⲉⲃⲟⲗ
ⲉⲃⲟⲗ`	ⲉⲃⲟⲗ
ⲉⲃ[ⲟⲗ]	ⲉⲃⲟⲗ
ⲉⲃ[........]	ⲉⲃ[........]
ⲉⲅⲕⲣⲁⲧⲉⲩⲉ̣	ⲉⲅⲕⲣⲁⲧⲉⲩⲉ
ⲉⲅⲕⲣⲁⲧⲉⲩⲉ	ⲉⲅⲕⲣⲁⲧⲉⲩⲉ
ⲉⲇⲉⲙ`	ⲉⲇⲉⲙ
ⲉⲑ	ⲉⲧ
ⲉⲓ̂	ⲉⲓ
ⲉⲓ̇ⲃⲉ	ⲉⲓⲃⲉ
ⲉⲓ̇ⲉ̇ⲣϩ̇	ⲉⲓⲉⲣϩ
ⲉⲓ̇ⲟ̇ⲧⲉ	ⲉⲓⲟⲧⲉ
ⲉⲓ̇ⲣⲉ	ⲉⲓⲣⲉ
ⲉⲓ̇ⲥ	ⲉⲓⲥ
ⲉⲓ̇ⲱⲣ̇ϩ	ⲉⲓⲱⲣϩ
ⲉⲓ̇ⲱⲧ	ⲉⲓⲱⲧ
ⲉⲓ̇	ⲉⲓ
ⲉⲓ̣̈ⲉ	ⲉⲓⲉ
ⲉⲓ̈ϣⲁⲛ	ⲉⲓϣⲁⲛ
ⲉⲓ̈ⲉ	ⲉⲓⲉ
ⲉⲓ̈ⲉ	ⲉⲓⲉ
ⲉⲓ̈ⲉ	ⲉⲓⲉ
ⲉⲓ̈ⲙⲏⲧⲓ`	ⲉⲓⲙⲏⲧⲓ
ⲉⲓ̈ⲣⲉ	ⲉⲓⲣⲉ
ⲉⲓ̈ⲥ	ⲉⲓⲥ
ⲉⲓ̈ⲧⲉ	ⲉⲓⲧⲉ
ⲉⲓ̈	ⲉⲓ
ⲉⲓ̣[ⲱⲣϩ]	ⲉⲓⲱⲣϩ
ⲉⲓⲁⲧ	ⲉⲓⲁⲧ
ⲉⲓⲃⲉ	ⲉⲓⲃⲉ
ⲉⲓⲃⲉ	ⲉⲓⲃⲉ
ⲉⲓⲇⲱⲗⲟⲛ⳿	ⲉⲓⲇⲱⲗⲟⲛ
ⲉⲓⲇⲱⲗⲟⲛ	ⲉⲓⲇⲱⲗⲟⲛ
ⲉⲓⲉⲣⲟ⳿	ⲓⲉⲣⲟ
ⲉⲓⲉ	ⲉⲓⲉ
ⲉⲓⲙ̣ⲉ	ⲉⲓⲙⲉ
ⲉⲓⲙⲉ	ⲉⲓⲙⲉ
ⲉⲓⲙⲉ`	ⲉⲓⲙⲉ
ⲉⲓⲙⲏⲧⲓ	ⲉⲓⲙⲏⲧⲓ
ⲉⲓⲙⲏⲧⲓ`	ⲉⲓⲙⲏⲧⲓ
ⲉⲓⲛⲉ̇	ⲉⲓⲛⲉ
ⲉⲓⲛⲉ	ⲉⲓⲛⲉ
ⲉⲓⲛⲉ`	ⲉⲓⲛⲉ
ⲉⲓⲟ̂ⲧⲉ⳿	ⲉⲓⲟⲧⲉ
ⲉⲓⲟⲟⲩⲉ⳿	ⲉⲓⲟⲟⲩⲉ
ⲉⲓⲟⲟⲩⲉ`	ⲉⲓⲟⲟⲩⲉ
ⲉⲓⲟⲧⲉ	ⲉⲓⲟⲧⲉ
ⲉⲓⲟⲧⲉ`	ⲉⲓⲟⲧⲉ
ⲉⲓⲣⲉ⳿	ⲉⲓⲣⲉ
ⲉⲓⲣⲉ	ⲉⲓⲣⲉ
ⲉⲓⲣⲉ`	ⲉⲓⲣⲉ
ⲉⲓⲣⲏⲛⲏ	ⲉⲓⲣⲏⲛⲏ
ⲉⲓⲣⲏⲛⲏ`	ⲉⲓⲣⲏⲛⲏ
ⲉⲓⲥ	ⲉⲓⲥ
ⲉⲓⲥ	ⲉⲓⲥ
ⲉⲓⲧⲁ	ⲉⲓⲧⲁ
ⲉⲓⲧⲉ	ⲉⲓⲧⲉ
ⲉⲓⲧⲉ`	ⲉⲓⲧⲉ
ⲉⲓⲱ̂	ⲉⲓⲱ
ⲉⲓⲱⲧ⳿	ⲉⲓⲱⲧ
ⲉⲓⲱⲧ	ⲉⲓⲱⲧ
ⲓⲱⲧ	ⲉⲓⲱⲧ
ⲓⲟⲧⲉ	ⲉⲓⲟⲧⲉ
ⲉⲓⲱⲧ`	ⲉⲓⲱⲧ
ⲉⲓ	ⲉⲓ
ⲉⲓ`	ⲉⲓ
ⲉⲕϣ̇ⲁⲛ	ⲉⲕϣⲁⲛ
ⲉⲕϣⲁⲛ	ⲉⲕϣⲁⲛ
ⲉⲕⲉ	ⲉⲕⲉ
ⲉⲕⲓⲃⲉ`	ⲉⲕⲓⲃⲉ
ⲉⲕⲕⲗⲏⲥⲓⲁ⳿	ⲉⲕⲕⲗⲏⲥⲓⲁ
ⲉⲕ	ⲉⲕ
ⲉⲗⲁⲭⲓⲥⲧⲟⲛ	ⲉⲗⲁⲭⲓⲥⲧⲟⲛ
ⲉⲗⲁⲭⲓⲥⲧⲟ⳯ ⳿	ⲉⲗⲁⲭⲓⲥⲧⲟⲛ
ⲉⲗⲓⲥⲁⲃⲉⲧ`	ⲉⲗⲓⲥⲁⲃⲉⲧ
ⲉⲗⲟⲟ̇ⲗⲉ	ⲉⲗⲟⲟⲗⲉ
ⲉⲙ	ⲙ
ⲉⲙ̇ⲧⲟⲛ	ⲉⲙⲧⲟⲛ
ⲉⲙⲁⲧⲉ⳿	ⲉⲙⲁⲧⲉ
ⲉⲙⲁⲧⲉ	ⲉⲙⲁⲧⲉ
ⲉⲙ︤ⲛ︦ⲧ︥	ⲉⲙⲛⲧ
ⲉⲛ̇ⲉ	ⲉⲛⲉ
ⲉⲛ̇ⲧ	ⲉⲛⲧ
ⲉⲛϣ̣ⲁⲛ	ⲉⲛϣⲁⲛ
ⲉⲛϣⲁⲛ	ⲉⲛϣⲁⲛ
ⲉⲛϣⲁⲛ`	ⲉⲛϣⲁⲛ
ⲉⲛⲉϩ⳿	ⲉⲛⲉϩ
ⲉⲛⲉϩ⳿	ⲉⲛⲉϩ
ⲉⲛⲉϩ	ⲉⲛⲉϩ
ⲉⲛⲉϩ`	ⲉⲛⲉϩ
ⲉⲛⲉϩ`	ⲉⲛⲉϩ
ⲉⲛⲉ	ⲉⲛⲉ
ⲉⲛⲉ	ⲉⲛⲉ
ⲉⲛⲉ	ⲉⲛⲉ
ⲉⲛⲉ.ⲉⲧⲏ	ϩⲉⲛⲉⲉⲧⲏ
ⲉⲛⲧⲏϭ	ⲉⲛⲧⲏϭ
ⲉⲛⲧⲟⲗⲏ̂	ⲉⲛⲧⲟⲗⲏ
ⲉⲛⲧⲟⲗⲏ̂`	ⲉⲛⲧⲟⲗⲏ
ⲉⲛⲧⲟⲗⲏ	ⲉⲛⲧⲟⲗⲏ
ⲉⲛⲧⲟⲗⲏ`	ⲉⲛⲧⲟⲗⲏ
ⲉⲛⲧ	ⲉⲛⲧ
ⲉⲛⲱⲭⲗⲉⲓ̇	ⲉⲛⲱⲭⲗⲉⲓ
ⲉⲛ	ⲉⲛ
ⲉⲛ	ⲛ
ⲉⲝⲁⲡⲁⲧⲁ	ⲉⲝⲁⲡⲁⲧⲁ
ⲉⲝⲟⲩⲥⲓⲁ	ⲉⲝⲟⲩⲥⲓⲁ
ⲉⲟⲟⲩ	ⲉⲟⲟⲩ
ⲉⲡⲁϩⲟⲩ	ⲉⲡⲁϩⲟⲩ
ⲉⲡⲉⲓⲇⲏ`	ⲉⲡⲉⲓⲇⲏ
ⲉⲡⲓⲑⲩⲙⲉⲓ⳿	ⲉⲡⲓⲑⲩⲙⲉⲓ
ⲉⲡⲓⲑⲩⲙⲉⲓ	ⲉⲡⲓⲑⲩⲙⲉⲓ
ⲉⲡⲓⲑⲩⲙⲓⲁ	ⲉⲡⲓⲑⲩⲙⲓⲁ
ⲉⲡⲓⲕⲁⲗⲉⲓ⳿	ⲉⲡⲓⲕⲁⲗⲉⲓ
ⲉⲡⲓⲥⲧⲏⲙⲏ	ⲉⲡⲓⲥⲧⲏⲙⲏ
ⲉⲡⲓⲥⲧⲟⲗⲏ̂	ⲉⲡⲓⲥⲧⲟⲗⲏ
ⲉⲡⲓⲥⲧⲟⲗⲏ	ⲉⲡⲓⲥⲧⲟⲗⲏ
ⲉⲡⲟⲓⲕⲓⲟ⳯ ⳿	ⲉⲡⲟⲓⲕⲓⲟⲛ 
ⲉⲡⲣⲁ⳿	ⲉⲡⲣⲁ
ⲉⲡⲣⲁ`	ⲉⲡⲣⲁ
ⲉⲡ⳿	ⲉⲡ
ⲉⲣ̄	ⲉⲣ
ⲉⲣ̇ⲙⲟⲛⲁⲭⲟⲥ	ⲣⲙⲟⲛⲁⲭⲟⲥ
ⲉⲣ̇ⲟ	ⲉⲣⲟ
ⲉⲣϢⲁⲛ	ⲉⲣϣⲁⲛ
ⲉⲣϣⲁⲛ	ⲉⲣϣⲁⲛ
ⲉⲣϣⲁ⳯	ⲉⲣϣⲁⲛ
ⲉⲣⲁⲧ︤	ⲉⲣⲁⲧ
ⲉⲣⲉ	ⲉⲣⲉ
ⲉⲣⲉ	ⲉⲣⲉ
ⲉⲣⲉ	ⲉⲣⲉ
ⲉⲣⲉ	ⲉⲣⲉ
ⲉⲣⲉ	ⲉⲣⲉ
ⲉⲣⲏⲧ⳿	ⲉⲣⲏⲧ
ⲉⲣⲏⲩ⳿	ⲉⲣⲏⲩ
ⲉⲣⲏⲩ	ⲉⲣⲏⲩ
ⲉⲣⲏⲩ`	ⲉⲣⲏⲩ
ⲉⲣⲟ̂	ⲉⲣⲟ
ⲉⲣⲟ	ⲉⲣⲟ
ⲉⲣⲟ	ⲉⲣⲟ
ⲉⲣⲱ	ⲉⲣⲱ
ⲉⲣ⳿ⲣ︤ⲙ︥ⲙⲁⲟ̂	ⲣⲣⲙⲙⲁⲟ
ⲉⲣ︤ⲛ︥	ⲉⲣⲛ
ⲉⲣ	ⲉⲣ
ⲉⲣ	ⲉⲣ
ⲉⲥ̇ⲑⲏⲧⲏ[ⲣⲓ]ⲟⲛ	ⲉⲥⲑⲏⲧⲏⲣⲓⲟⲛ
ⲉⲥⲏⲧ	ⲉⲥⲏⲧ
ⲉⲥⲏⲧ`	ⲉⲥⲏⲧ
ⲉⲥⲑⲁⲛⲉ	ⲉⲥⲑⲁⲛⲉ
ⲉⲥⲑⲏⲧⲏⲣⲓⲟⲛ	ⲉⲥⲑⲏⲧⲏⲣⲓⲟⲛ
ⲉⲥⲟⲟⲩ	ⲉⲥⲟⲟⲩ
ⲉⲥⲟⲟⲩ`	ⲉⲥⲟⲟⲩ
ⲉⲥ	ⲉⲥ
ⲉⲦ	ⲉⲧ
ⲉⲧ̇	ⲉⲧ
ⲉⲧ̣[ⲃⲉ	ⲉⲧⲃⲉ
ⲉⲧⲃ̣	ⲉⲧⲃ
ⲉⲧⲃⲉ	ⲉⲧⲃⲉ
ⲉⲧⲃⲏⲧ	ⲉⲧⲃⲏⲏⲧ
ⲉⲧⲃⲏⲏ̂ⲧ	ⲉⲧⲃⲏⲏⲧ
ⲉⲧⲃⲏⲏⲧ︤	ⲉⲧⲃⲏⲏⲧ
ⲉⲧⲃⲏⲏⲧ	ⲉⲧⲃⲏⲏⲧ
ⲉⲧⲃⲏⲏ	ⲉⲧⲃⲏⲏ
ⲉⲧⲉⲣⲉ	ⲉⲧⲉⲣⲉ
ⲉⲧⲉⲣⲉ	ⲉⲧⲉⲣⲉ
ⲉⲧⲉⲣⲉ	ⲉⲧⲉⲣⲉ
ⲉⲧⲉⲣⲉ	ⲉⲧⲉⲣⲉ
ⲉⲧⲉⲧ︤ⲛ︥ϣⲁⲛ	ⲉⲧⲉⲧⲛϣⲁⲛ
ⲉⲧⲉ	ⲉⲧⲉ
ⲉⲧⲉ	ⲉⲧⲉ
ⲉⲧⲓ	ⲉⲧⲓ
ⲉⲧⲟⲟⲧ︤	ⲉⲧⲟⲟⲧ
ⲉⲧⲟⲟⲧ	ⲉⲧⲟⲟⲧ
ⲉⲧ︤ⲃ︥ⲃⲏ	ⲉⲧⲃⲃⲏ
ⲉⲧ︤	ⲉⲧ
ⲉⲧ	ⲉⲧ
ⲉⲧ	ⲉⲧ
ⲉⲧ	ⲧⲉⲧⲛ
ⲉⲧ`	ⲉⲧ
ⲉⲩ̣ⲉ	ⲉⲩⲉ
ⲉⲩϣⲁⲛ	ⲉⲩϣⲁⲛ
ⲉⲩϩⲁ	ⲉⲩϩⲁ
ⲉⲩⲉ	ⲉⲩⲉ
ⲉⲩⲉ	ⲉⲩⲉ
ⲉⲩⲣⲓⲡⲟⲥ⳿	ⲉⲩⲣⲓⲡⲟⲥ
ⲉⲩⲫⲣⲁⲛⲉ`	ⲉⲩⲫⲣⲁⲛⲉ
ⲉⲩ	ⲉⲩ
ⲉ⳯ⲧⲟⲗⲏ̂	ⲉⲛⲧⲟⲗⲏ
ⲉ⳯ⲧ	ⲉⲛⲧ
ⲉ⳿	ⲉ
ⲉ	ⲉ
ⲉ	ⲉ
ⲉ	ⲉ
ⲉ	ⲉⲧ
ⲉ	ⲉ
ⲉ	ϩⲉ
ⲉ	ⲉ
ⲉ	ⲉ
ⲉ	ⲉ
ⲉ[ϩ]ⲣⲁⲓ	ⲉϩⲣⲁⲓ
ⲉ[ⲓⲧ]ⲉ̣	ⲉⲓⲧⲉ
ⲉ[ⲓⲱ]ⲧ	ⲉⲓⲱⲧ
ⲉ[ⲧⲃ]ⲉ	ⲉⲧⲃⲉ
ⲉ[ⲧ	ⲉⲧ
ⲉ[ⲧ]	ⲉⲧ
ⲉ]ⲡⲓⲥⲧⲟⲗⲏ	ⲉⲡⲓⲥⲧⲟⲗⲏ
ⲉ`	ϩⲉ
ⲍⲁⲭⲁⲣⲓⲁⲥ	ⲍⲁⲭⲁⲣⲓⲁⲥ
ⲍⲉⲗⲫⲁ	ⲍⲉⲗⲫⲁ
ⲍⲱⲟⲛ	ⲍⲱⲟⲛ
ⲏ̣̂	ⲏ
ⲏ̂ⲣⲡ̄	ⲏⲣⲡ
ⲏ̂ⲣ︤ⲡ︥	ⲏⲣⲡ
ⲏ̂ⲥⲁⲓ̈ⲁⲥ	ⲏⲥⲁⲓⲁⲥ
ⲏ̂ⲥⲁⲩ	ⲏⲥⲁⲩ
ⲏ̂ⲥⲁⲩ`	ⲏⲥⲁⲩ
ⲏ̂	ⲏ
ⲏ̄	ⲏ
ⲏ̣̇	ⲏ
ⲏ̇ⲣⲡ̇	ⲏⲣⲡ
ⲏ̇	ⲏ
ⲏ̈ⲓ	ⲏⲓ
ⲏ̣̇	ⲏ
ⲏ̣ⲇ̣ⲟ̣ⲛ̣ⲏ̣	ϩⲏⲇⲟⲛⲏ
ⲏ̣	̣ⲏ
ⲏⲉⲓ	ⲏⲉⲓ
ⲏⲓ̈	ⲏⲓ
ⲏⲡ̂	ⲏⲡ
ⲏⲡ⳿	ⲏⲡ
ⲏⲡ	ⲏⲡ
ⲏⲡ`	ⲏⲡ
ⲏⲣ̇ⲡ̇	ⲏⲣⲡ
ⲏⲣⲡ̇	ⲏⲣⲡ
ⲏⲣ︤ⲡ︥	ⲏⲣⲡ
ⲏ⳱	ⲏ
ⲏ⳿	ⲏ
ⲏ	ⲏ
ⲏ]	ⲏ
ⲏ`	ⲏ
Ⲑ	ⲧ
ⲑ̇ⲃⲃⲓ̇ⲟ̇	ⲑⲃⲃⲓⲟ
ⲑ̇ⲗⲓ̇ⲃⲉ	ⲑⲗⲓⲃⲉ
ⲑ̇ⲗⲓ̇ⲯⲓ̇ⲥ	ⲑⲗⲓⲯⲓⲥ
ⲑ̇ⲗⲓ̈ⲯⲓ̇ⲥ	ⲑⲗⲓⲯⲓⲥ
ⲑ̣	ⲧ
ⲑⲃ̄ⲃⲓⲟ	ⲑⲃⲃⲓⲟ
ⲑⲃ̇ⲃⲓ̇ⲉ̇	ⲑⲃⲃⲓⲉ
ⲑⲉⲱ̇ⲇⲟⲣⲟⲥ	ⲑⲉⲟⲇⲟⲣⲟⲥ
ⲑⲉⲱ̇ⲇⲱⲣⲟⲥ	ⲑⲉⲱⲇⲱⲣⲟⲥ
ⲑⲉⲱⲫⲓⲗⲟⲥ	ⲑⲉⲱⲫⲓⲗⲟⲥ
ⲑⲗ̣ⲓ̣ⲯⲓⲥ	ⲑⲗⲓⲯⲓⲥ
ⲑⲗⲓ̇ⲯⲓ̇ⲥ	ⲑⲗⲓⲯⲓⲥ
ⲑⲗⲓⲃⲉ⳿	ⲑⲗⲓⲃⲉ
ⲑⲗⲓⲯⲓⲥ⳿	ⲑⲗⲓⲯⲓⲥ
ⲑⲗⲓⲯⲓⲥ	ⲑⲗⲓⲯⲓⲥ
ⲑⲙ̄ⲕⲟ	ⲑⲙⲕⲟ
ⲑⲙⲕⲟ	ⲑⲙⲕⲟ
ⲑⲛⲟⲛ`	ⲑⲛⲟⲛ
ⲑⲟⲟⲩ	ϩⲟⲟⲩ
ⲑⲟⲟⲩ`	ϩⲟⲟⲩ
ⲑ︤ⲙ︥ⲕⲟ	ⲑⲙⲕⲟ
ⲑ︤	ⲧ
ⲑ︦	ⲧ
ⲑ	ⲧⲉ
ⲑ	ⲧ
ⲑⲩⲥⲥⲁⲥⲧⲏⲣⲓⲟⲛ	ⲑⲩⲥⲓⲁⲥⲧⲏⲣⲓⲟⲛ
Ⲓ̈ⲁⲕⲱⲃ	ⲓⲁⲕⲱⲃ
Ⲓ̈ⲟⲩⲇⲁⲥ	ⲓⲟⲩⲇⲁⲥ
Ⲓ̈ⲥⲁⲁⲕ`	ⲓⲥⲁⲁⲕ
Ⲓⲟⲩ[ⲇⲁⲥ	ⲓⲟⲩⲇⲁⲥ
ⲓ̇ⲇⲟⲥ	ⲉⲓⲇⲟⲥ
ⲓ̇ⲉⲢⲟ	ⲓⲉⲣⲟ
ⲓ̇ⲥⲁⲕ	ⲓⲥⲁⲕ
ⲓ̇ⲱⲥⲏⲫ	ⲓⲱⲥⲏⲫ
ⲓ̇︦︦︦︦ⲗ︦ⲏ︦ⲙ︦	ϩⲓⲉⲣⲟⲩⲥⲁⲗⲏⲙ
ⲓ̇	ⲓ
ⲓ̇	ⲓ
ⲓ̈ⲁⲕⲱⲃ	ⲓⲁⲕⲱⲃ
ⲓ̈ⲁⲕⲱⲃ`	ⲓⲁⲕⲱⲃ
ⲓ̈ⲉⲍⲉⲕⲓⲏⲗ`	ⲓⲉⲍⲉⲕⲓⲏⲗ
ⲓ̈ⲉⲣⲉⲙⲓⲁⲥ`	ⲓⲉⲣⲉⲙⲓⲁⲥ
ⲓ̈ⲟⲩⲇⲁⲥ`	ⲓⲟⲩⲇⲁⲥ
ⲓ̈ⲥⲁⲁⲕ	ⲓⲥⲁⲁⲕ
ⲓ̈ⲥⲁⲁⲕ`	ⲓⲥⲁⲁⲕ
ⲓ̈ⲥⲙⲁⲏⲗ	ⲓⲥⲙⲁⲏⲗ
ⲓ̈ⲱϩⲁⲛⲛⲏⲥ`	ⲓⲱϩⲁⲛⲛⲏⲥ
ⲓ̈ⲱⲥⲏⲫ`	ⲓⲱⲥⲏⲫ
ⲓ̈ⲱⲥⲓⲁⲥ	ⲓⲱⲥⲓⲁⲥ
ⲓ̈ⲱⲧ`	ⲉⲓⲱⲧ
ⲓ̈⳿	ⲓ
ⲓ̈	ⲓ
ⲓ̈	ⲓ
ⲓ︤ⲏ︦ⲗ︥	ⲓⲥⲣⲁⲏⲗ
ⲓ︤ⲏ︦ⲥ︥	ⲓⲏⲥⲟⲩⲥ
ⲓ︤ⲗ︥︦︤ⲏ︦︥︤ⲙ︦︥	ϩⲓⲉⲣⲟⲩⲥⲁⲗⲏⲙ
ⲓ︤ⲥ︥	ⲓⲏⲥⲟⲩⲥ
ⲓ︤ⲥ︥	ⲓⲏⲥⲟⲩⲥ
ⲓ︤ⲥ︥`	ⲓⲏⲥⲟⲩⲥ
ⲓ︦ⲏ︦ⲗ︥	ⲓⲥⲣⲁⲏⲗ
ⲓ︦ⲗ︦ⲏ︦ⲙ︥	ϩⲓⲉⲣⲟⲩⲥⲁⲗⲏⲙ
ⲓ︦ⲥ︦	ⲓⲏⲥⲟⲩⲥ
ⲓ	ⲓ
ⲓ	ⲓ
Ⲕⲉ	ⲕⲉ
ⲕ̇ⲧⲟ	ⲕⲧⲟ
ⲕ̇	ⲕ
ⲕ̣ⲁⲁ	ⲕⲁⲁ
ⲕ̣ⲟⲗⲁⲍ̣ⲉ	ⲕⲟⲗⲁⲍⲉ
ⲕⲁ̇ⲁ	ⲕⲁⲁ
ⲕⲁϩ̇	ⲕⲁϩ
ⲕⲁϩ⳿	ⲕⲁϩ
ⲕⲁϩ	ⲕⲁϩ
ⲕⲁϩ`	ⲕⲁϩ
ⲕⲁϫⲣⲟⲡ	ⲕⲁϫⲣⲟⲡ
ⲕⲁⲁ	ⲕⲁⲁ
ⲕⲁⲃⲟⲗ⳿	ⲕⲁⲃⲟⲗ
ⲕⲁⲓⲣⲟⲥ⳿	ⲕⲁⲓⲣⲟⲥ
ⲕⲁⲓⲣⲟⲥ	ⲕⲁⲓⲣⲟⲥ
ⲕⲁⲕⲉ	ⲕⲁⲕⲉ
ⲕⲁⲕⲉ`	ⲕⲁⲕⲉ
ⲕⲁⲕⲓⲁ⳿	ⲕⲁⲕⲓⲁ
ⲕⲁⲗⲱⲥ	ⲕⲁⲗⲱⲥ
ⲕⲁⲛ⳿	ⲕⲁⲛ
ⲕⲁⲛ	ⲕⲁⲛ
ⲕⲁⲛ`	ⲕⲁⲛ
ⲕⲁⲡⲛⲟⲥ	ⲕⲁⲡⲛⲟⲥ
ⲕⲁⲣⲡⲟⲥ	ⲕⲁⲣⲡⲟⲥ
ⲕⲁⲣⲱϥ	ⲕⲁⲣⲱϥ
ⲕⲁⲥⲓ̇ⲁ̇ⲛⲟⲥ	ⲕⲁⲥⲓⲁⲛⲟⲥ
ⲕⲁⲧⲁⲕⲗⲩⲥⲙⲟⲥ	ⲕⲁⲧⲁⲕⲗⲩⲥⲙⲟⲥ
ⲕⲁⲧⲁⲕⲣⲓⲙⲁ	ⲕⲁⲧⲁⲕⲣⲓⲙⲁ
ⲕⲁⲧⲁⲫⲣⲟⲛⲉⲓ̈	ⲕⲁⲧⲁⲫⲣⲟⲛⲉⲓ
ⲕⲁⲧⲁⲫⲣⲟⲛⲉⲓ	ⲕⲁⲧⲁⲫⲣⲟⲛⲉⲓ
ⲕⲁⲧⲁ	ⲕⲁⲧⲁ
ⲕⲁ	ⲕⲁ
ⲕⲁ`	ⲕⲁ
ⲕⲃⲁ⳿	ⲕⲃⲁ
ⲕⲃⲁ	ⲕⲃⲁ
ⲕⲉⲉⲥ	ⲕⲉⲉⲥ
ⲕⲉⲧ⳿	ⲕⲉⲧ
ⲕⲉⲧ	ⲕⲉⲧ
ⲕⲉ	ⲕⲉ
ⲕⲉ	ⲕⲉ
ⲕⲏⲃ⳿	ⲕⲏⲃ
ⲕⲏⲕⲁϩⲏⲩ	ⲕⲏⲕⲁϩⲏⲩ
ⲕⲏ	ⲕⲏ
ⲕⲓϣⲉ	ϣⲓⲕⲉ
ⲕⲓⲙ	ⲕⲓⲙ
ⲕⲓⲙ`	ⲕⲓⲙ
ⲕⲗ̇ⲗⲉ	ⲕⲗⲗⲉ
ⲕⲗⲁϥ︤ⲧ︥	ⲕⲗⲁϥⲧ
ⲕⲗⲏⲣⲟⲛⲟⲙⲉⲓ	ⲕⲗⲏⲣⲟⲛⲟⲙⲉⲓ
ⲕⲗⲏⲣⲟⲛⲟⲙⲉⲓ`	ⲕⲗⲏⲣⲟⲛⲟⲙⲉⲓ
ⲕⲗⲏⲣⲟⲛⲟⲙⲓⲁ`	ⲕⲗⲏⲣⲟⲛⲟⲙⲓⲁ
ⲕⲗⲏⲣⲟⲛⲟⲙⲓ	ⲕⲗⲏⲣⲟⲛⲟⲙⲉⲓ
ⲕⲟⲓⲛⲱⲛⲟⲥ	ⲕⲟⲓⲛⲱⲛⲟⲥ
ⲕⲟⲗⲁⲍⲉ	ⲕⲟⲗⲁⲍⲉ
ⲕⲟⲗⲁⲥⲓ̇ⲥ	ⲕⲟⲗⲁⲥⲓⲥ
ⲕⲟⲗⲁⲥⲓⲥ	ⲕⲟⲗⲁⲥⲓⲥ
ⲕⲟⲗⲗⲩϭⲉ	ⲕⲟⲗⲗⲏⲅⲓⲟⲛ
ⲕⲟⲗⲗⲩⲕⲓ̇ⲟⲛ	ⲕⲟⲗⲗⲏⲅⲓⲟⲛ
ⲕⲟⲙⲉⲥ	ⲕⲟⲙⲉⲥ
ⲕⲟⲛⲥ	ⲕⲟⲛⲥ
ⲕⲟⲞⲩⲉ`	ⲕⲟⲟⲩⲉ
ⲕⲟⲟⲩⲉ̇	ⲕⲟⲟⲩⲉ
ⲕⲟⲟⲩⲉ⳿	ⲕⲟⲟⲩⲉ
ⲕⲟⲟⲩⲉ	ⲕⲟⲟⲩⲉ
ⲕⲟⲟⲩⲉ`	ⲕⲟⲟⲩⲉ
ⲕⲟⲟⲩ	ⲕⲟⲟⲩ
ⲕⲟⲥⲙⲟⲥ	ⲕⲟⲥⲙⲟⲥ
ⲕⲟⲧ︤ⲥ︥	ⲕⲟⲧⲥ
ⲕⲟⲧ	ⲕⲟⲧ
ⲕⲟⲩⲓ̇	ⲕⲟⲩⲓ
ⲕⲟⲩⲓ̈	ⲕⲟⲩⲓ
ⲕⲟⲩⲓ	ⲕⲟⲩⲓ
ⲕⲣⲓ̇ⲥⲓ̇ⲥ	ⲕⲣⲓⲥⲓⲥ
ⲕⲣⲓⲛⲉ	ⲕⲣⲓⲛⲉ
ⲕⲣⲓⲥⲓⲥ	ⲕⲣⲓⲥⲓⲥ
ⲕⲣⲓⲧⲏⲥ	ⲕⲣⲓⲧⲏⲥ
ⲕⲣⲟϥ	ⲕⲣⲟϥ
ⲕⲣⲟϥ`	ⲕⲣⲟϥ
ⲕⲣⲟⲛⲟⲥ⳿	ⲕⲣⲟⲛⲟⲥ
ⲕⲣⲟⲛⲟⲥ⳿	ⲕⲣⲟⲛⲟⲥ
ⲕⲧⲉ	ⲕⲧⲉ
ⲕⲧⲟ	ⲕⲧⲟ
ⲕⲧⲟ`	ⲕⲧⲟ
ⲕⲱ̂	ⲕⲱ
ⲕⲱϩ︤ⲧ︥	ⲕⲱϩⲧ
ⲕⲱϩ	ⲕⲱϩ
ⲕⲱⲃ`	ⲕⲱⲃ
ⲕⲱⲗⲩⲉ	ⲕⲱⲗⲩⲉ
ⲕⲱⲗⲩⲉ`	ⲕⲱⲗⲩⲉ
ⲕⲱⲗⲩ`	ⲕⲱⲗⲩ
ⲕⲱⲙ︤ϣ︥	ⲕⲱⲙϣ
ⲕⲱⲥⲙⲓⲕⲟⲛ	ⲕⲱⲥⲙⲓⲕⲟⲛ
ⲕⲱⲧⲉ	ⲕⲱⲧⲉ
ⲕⲱⲧⲉ	ⲕⲱⲧⲉ
ⲕⲱⲧⲉ`	ⲕⲱⲧⲉ
ⲕⲱⲧ⳿	ⲕⲱⲧ
ⲕⲱⲧ`	ⲕⲱⲧ
ⲕⲱ⳿	ⲕⲱ
ⲕⲱ	ⲕⲱ
ⲕⲱ	ⲕⲱ
ⲕⲱ`	ⲕⲱ
ⲕ⳿	ⲕ
ⲕ︤	ⲕ
ⲕ︥	ⲕ
ⲕ︥	ⲕ
ⲕ︥`	ⲕ
ⲕ	ⲕ
ⲕ	ⲕ
ⲕ`	ⲕ
ⲖⲁⲁⲨ	ⲗⲁⲁⲩ
ⲗ̇ⲁⲥ	ⲗⲁⲥ
ⲗ̣ⲟ̣ⲑ̣	ⲗⲟⲑ
ⲗ̣ⲟ̣	ⲗⲟ
ⲗϩⲏⲙ	ⲗϩⲏⲙ
ⲗⲁ̇ⲁⲩ	ⲗⲁⲁⲩ
ⲗⲁⲁ̇ⲩ	ⲗⲁⲁⲩ
ⲗⲁⲁⲩ	ⲗⲁⲁⲩ
ⲗⲁⲁⲩ`	ⲗⲁⲁⲩ
ⲗⲁⲟⲥ⳿	ⲗⲁⲟⲥ
ⲗⲁⲟⲥ	ⲗⲁⲟⲥ
ⲗⲁⲟⲥ`	ⲗⲁⲟⲥ
ⲗⲁⲥ	ⲗⲁⲥ
ⲗⲉⲗⲟⲩ	ⲗⲉⲗⲟⲩ
ⲗⲓⲁ	ⲗⲓⲁ
ⲗⲓⲧⲟⲩⲣⲅⲓ̇ⲁ̇	ⲗⲓⲧⲟⲩⲣⲅⲓⲁ
ⲗⲗⲏⲃ	ⲗⲗⲏⲃ
ⲗⲟⲅⲟⲥ	ⲗⲟⲅⲟⲥ
ⲗⲟⲙ︤ⲥ︥	ⲗⲟⲙⲥ
ⲗⲟ	ⲗⲟ
ⲗⲟ`	ⲗⲟ
ⲗⲩⲡⲉⲓ	ⲗⲩⲡⲉⲓ
ⲗⲩⲡⲉⲓ`	ⲗⲩⲡⲉⲓ
ⲗⲩⲡⲏ	ⲗⲩⲡⲏ
ⲗⲩⲥⲧⲏⲥ	ⲗⲏⲥⲧⲏⲥ
ⲗⲩⲭⲛⲓⲁ	ⲗⲩⲭⲛⲓⲁ
ⲗⲩⲭ[ⲛⲓⲁ	ⲗⲩⲭⲛⲓⲁ
ⲗⲱϫ︤ϩ︥	ⲗⲱϫϩ
Ⲙ̄ⲙ︤ⲛ︥	ⲙⲙⲛ
Ⲙ̄ⲡⲱⲣ`	ⲙⲡⲱⲣ
Ⲙ̄ⲡ︤ⲣ︥	ⲙⲡⲣ
Ⲙⲉⲛ`	ⲙⲉⲛ
Ⲙⲏ⳿	ⲙⲏ
Ⲙⲏ	ⲙⲏ
Ⲙⲡⲉ	ⲙⲡⲉ
ⲙ̣̄̄ⲙ︤ⲛ︥	ⲙⲙⲛ
ⲙ̣̄	ⲙ
ⲙ̄ⲕⲁϩ	ⲙⲕⲁϩ
ⲙ̄ⲕⲁϩ	ⲙⲕⲁϩ
ⲙ̄ⲕⲁϩ`	ⲙⲕⲁϩ
ⲙ̄ⲙ̄ⲙⲟ	ⲙⲙⲟ
ⲙ̄ⲙⲁ̣	ⲙⲙⲁ
ⲙ̄ⲙⲁⲁⲩ	ⲙⲙⲁⲁⲩ
ⲙ̄ⲙⲁⲧⲉ	ⲙⲙⲁⲧⲉ
ⲙ̄ⲙⲁⲩ	ⲙⲙⲁⲩ
ⲙ̄ⲙⲁⲩ`	ⲙⲙⲁⲩ
ⲙ̄ⲙⲁ	ⲙⲙⲁ
ⲙ̄ⲙⲏⲛⲉ	ⲙⲙⲏⲛⲉ
ⲙ̄ⲙⲓ̈ⲛ	ⲙⲙⲓⲛ
ⲙ̄ⲙⲓⲛⲙ̄ⲙⲟ	ⲙⲙⲓⲛⲙⲙⲟ
ⲙ̄ⲙⲓⲛⲙ̄ⲙⲟ	ⲙⲙⲓⲛⲙⲙⲟ
ⲙ̄ⲙⲓⲛⲙ̄ⲙⲱ	ⲙⲙⲓⲛⲙⲙⲱ
ⲙ̄ⲙⲓⲛ⳿ⲙ̄ⲙⲱ	ⲙⲙⲓⲛⲙⲙⲱ
ⲙ̄ⲙⲓⲛ[ⲙ]ⲙⲟ	ⲙⲙⲓⲛⲙⲙⲟ
ⲙ̄ⲙⲓⲛ`ⲙ̄ⲙⲟ	ⲙⲙⲓⲛⲙⲙⲟ
ⲙ̄ⲙⲓⲛ`ⲙ̄ⲙⲱ	ⲙⲙⲓⲛⲙⲙⲱ
ⲙ̄ⲙⲟⲛ	ⲙⲙⲟⲛ
ⲙ̄ⲙⲟⲛ`	ⲙⲙⲟⲛ
ⲙ̄ⲙⲟⲟⲩ	ⲙⲙⲟⲟⲩ
ⲙ̄ⲙⲟⲩ	ⲙⲙⲟⲩ
ⲙ̄ⲙⲟ	ⲙⲙⲟ
ⲙ̄ⲙⲟ	ⲙⲙⲟ
ⲙ̄ⲙⲟ	ⲙⲙⲟ
ⲙ̄ⲙⲱ	ⲙⲙⲱ
ⲙ̄ⲙ︤ⲛ̣̄	ⲙⲙⲛ
ⲙ̄ⲙ︤ⲛ︥ⲧⲉ	ⲙⲙⲛⲧⲉ
ⲙ̄ⲙ︤ⲛ︥	ⲙⲙⲛ
ⲙ̄ⲡ̣	ⲙⲡ
ⲙ̄ⲡϣⲁ	ⲙⲡϣⲁ
ⲙ̄ⲡϣⲁ	ⲙⲡϣⲁ
ⲙ̄ⲡϣⲁ`	ⲙⲡϣⲁ
ⲙ̄ⲡⲁⲧⲉ	ⲙⲡⲁⲧⲉ
ⲙ̄ⲡⲁ	ⲙⲡⲁⲧ
ⲙ̄ⲡⲁ	ⲙⲡⲁ
ⲙ̄ⲡⲉ	ⲙⲡⲉ
ⲙ̄ⲡⲉ	ⲙⲡⲉ
ⲙ̄ⲡⲟⲩ	ⲙⲡⲟⲩ
ⲙ̄ⲡⲣ̄	ⲙⲡⲣ
ⲙ̄ⲡⲣ	ⲙⲡⲣ
ⲙ̄ⲡⲱⲣ	ⲙⲡⲱⲣ
ⲙ̄ⲡⲱⲣ	ⲙⲡⲱⲣ
ⲙ̄ⲡⲱⲣ`	ⲙⲡⲱⲣ
ⲙ̄ⲡ︤ⲣ︥	ⲙⲡⲣ
ⲙ̄ⲡ︤ⲣ︥	ⲙⲡⲣ
ⲙ̄ⲡ︤	ⲙⲡ
ⲙ̄ⲡ︤	ⲙⲡ
ⲙ̄ⲡ	ⲙⲡ
ⲙ̄ⲧⲟ̂	ⲙⲧⲟ
ⲙ̄ⲧⲟⲛ	ⲙⲧⲟⲛ
ⲙ̄ⲧⲟⲛ	ⲙⲧⲟⲛ
ⲙ̄ⲧⲟⲛ`	ⲙⲧⲟⲛ
ⲙ̄ⲧⲟ	ⲙⲧⲟ
ⲙ̄	ⲙ
ⲙ̄	ⲙ
ⲙ̄	ⲙⲙⲟ
ⲙ̄	ⲙ
ⲙ̄[ ]	ⲙ[ ]
ⲙ̇ⲁ	ⲙⲁ
ⲙ̇ⲙⲁⲧⲉ	ⲙⲙⲁⲧⲉ
ⲙ̇ⲙⲁⲩ	ⲙⲙⲁⲩ
ⲙ̇ⲙⲓ̇ⲛⲙⲙⲟ	ⲙⲙⲓⲛⲙⲙⲟ
ⲙ̇ⲙⲟ	ⲙⲙⲟ
ⲙ̇ⲙⲱ	ⲙⲙⲱ
ⲙ̇ⲛ	ⲙⲛ
ⲙ̇ⲡⲁⲧⲉ	ⲙⲡⲁⲧ
ⲙ̇ⲡⲉ	ⲙⲡⲉ
ⲙ̇ⲡⲣ̇	ⲙⲡⲣ
ⲙ̇ⲡ	ⲙⲡ
ⲙ̇ⲧⲟⲛ̇	ⲙⲧⲟⲛ
ⲙ̇ⲧⲟⲛ	ⲙⲧⲟⲛ
ⲙ̇ⲧⲟⲛ	ⲙⲧⲟⲛ
ⲙ̇	ⲙ
ⲙ̇	ⲙ
ⲙ̣̄ⲙⲟ	ⲙⲙⲟ
ⲙ̣̄ⲡ̣̣ϣⲁ	ⲙⲡϣⲁ
ⲙ̣ⲁ̣ⲩ̣ⲁⲁ	ⲙⲁⲩⲁⲁ
ⲙ̣ⲁϣⲉ	ⲙⲁϣⲉ
ⲙ̣ⲁⲣ︤	ⲙⲁⲣ
ⲙ̣ⲉϣ̣ⲁ	ⲙⲉϣⲁ
ⲙ̣ⲉⲧⲁⲛⲟⲉⲓ	ⲙⲉⲧⲁⲛⲟⲉⲓ
ⲙ̣ⲉ	ⲙⲉ
ⲙ̣ⲉ	ⲙⲉ
ⲙ̣ⲓⲛⲉ	ⲙⲓⲛⲉ
ⲙ̣ⲙⲟ	ⲙⲙⲟ
ⲙ̣ⲟⲩϩ	ⲙⲟⲩϩ
ⲙ̣ⲟⲩ	ⲙⲟⲩ
ⲙ̣︤ⲛ︥	ⲙⲛ
ⲙ̣[ⲙⲁ]ⲩ	ⲙⲙⲁⲩ
ⲙ̣[ⲡⲉ	ⲙⲡⲉ
ⲙ̣[.....]ⲟⲓ	ⲙ[.....]ⲟⲓ
ⲙϩⲁⲁⲩ	ⲙϩⲁⲁⲩ
ⲙⲁϣⲉ	ⲙⲁϣⲉ
ⲙⲁⲁϫⲉ⳿	ⲙⲁⲁϫⲉ
ⲙⲁⲁⲃ	ⲙⲁⲁⲃ
ⲙⲁⲁⲩ	ⲙⲁⲁⲩ
ⲙⲁⲁⲩ`	ⲙⲁⲁⲩ
ⲙⲁⲁ	ⲙⲁⲁ
ⲙⲁⲅⲉⲓⲣⲟⲥ⳿	ⲙⲁⲅⲉⲓⲣⲟⲥ
ⲙⲁⲑⲏⲧⲏⲥ	ⲙⲁⲑⲏⲧⲏⲥ
ⲙⲁⲓ̈ⲛⲟⲩⲧⲉ	ⲙⲁⲓⲛⲟⲩⲧⲉ
ⲙⲁⲓ̈	ⲙⲁⲓ
ⲙⲁⲕⲁⲣⲓ̇ⲟⲥ	ⲙⲁⲕⲁⲣⲓⲟⲥ
ⲙⲁⲕⲁⲣⲓⲍⲉ	ⲙⲁⲕⲁⲣⲓⲍⲉ
ⲙⲁⲕⲁⲣⲓⲟⲥ	ⲙⲁⲕⲁⲣⲓⲟⲥ
ⲙⲁⲕ︤ϩ︥	ⲙⲁⲕϩ
ⲙⲁⲗⲁⲕⲟⲥ	ⲙⲁⲗⲁⲕⲟⲥ
ⲙⲁⲗⲓⲤⲧⲁ	ⲙⲁⲗⲓⲥⲧⲁ
ⲙⲁⲗⲓⲥⲧⲁ⳿	ⲙⲁⲗⲓⲥⲧⲁ
ⲙⲁⲗⲓⲥⲧⲁ	ⲙⲁⲗⲓⲥⲧⲁ
ⲙⲁⲗⲓⲥⲧⲁ`	ⲙⲁⲗⲓⲥⲧⲁ
ⲙⲁⲙⲙⲱⲛⲁⲥ⳿	ⲙⲁⲙⲙⲱⲛⲁⲥ
ⲙⲁⲣⲉ	ⲙⲁⲣⲉ
ⲙⲁⲣ︤ⲛ︥	ⲙⲁⲣⲛ
ⲙⲁⲣ︤	ⲙⲁⲣ
ⲙⲁⲣ︤	ⲙⲁⲣ
ⲙⲁⲣ︥	ⲙⲁⲣ
ⲙⲁⲣ	ⲙⲁⲣ
ⲙⲁⲥⲉ⳿	ⲙⲁⲥⲉ
ⲙⲁⲥⲉ	ⲙⲁⲥⲉ
ⲙⲁⲥⲧⲏⲝ	ⲙⲁⲥⲧⲏⲝ
ⲙⲁⲥⲧⲓⲅⲟⲩ	ⲙⲁⲥⲧⲓⲅⲟⲩ
ⲙⲁⲥⲧⲓⲅⲟⲩ	ⲙⲁⲥⲧⲓⲅⲟⲩ
ⲙⲁⲥⲧⲓⲕ[ⲟⲩ]	ⲙⲁⲥⲧⲓⲅⲟⲩ
ⲙⲁⲧⲉ	ⲙⲁⲧⲉ
ⲙⲁⲩⲁ̇ⲁ	ⲙⲁⲩⲁⲁ
ⲙⲁⲩⲁⲁ̇	ⲙⲁⲩⲁⲁ
ⲙⲁⲩⲁⲁⲧ	ⲙⲁⲩⲁⲁⲧ
ⲙⲁⲩⲁⲁ	ⲙⲁⲩⲁⲁ
ⲙⲁⲩⲁⲧ	ⲙⲁⲩⲁⲧ
ⲙⲁ⳱	ⲙⲁ
ⲙⲁ⳿	ⲙⲁ
ⲙⲁ	ⲙⲁ
ⲙⲁ	ⲙⲁ
ⲙⲁ]ⲩ̣ⲁ	ⲙⲁⲩⲁ
ⲙⲁ`	ⲙⲁ
ⲙⲉ̣ⲧⲁⲛⲟⲉⲓ	ⲙⲉⲧⲁⲛⲟⲉⲓ
ⲙⲉϣϣⲉ	ⲙⲉϣϣⲉ
ⲙⲉϣ︤ⲧ︥	ⲙⲉϣⲧ
ⲙⲉϩ̣	ⲙⲉϩ
ⲙⲉϩ	ⲙⲉϩ
ⲙⲉϩ	ⲙⲉϩ
ⲙⲉⲉ̇ⲩⲉ̇	ⲙⲉⲉⲩⲉ
ⲙⲉⲉⲣⲉ	ⲙⲉⲉⲣⲉ
ⲙⲉⲉⲩⲉ̇	ⲙⲉⲉⲩⲉ
ⲙⲉⲉⲩⲉ	ⲙⲉⲉⲩⲉ
ⲙⲉⲉⲩⲉ	ⲙⲉⲉⲩⲉ
ⲙⲉⲉⲩⲉ`	ⲙⲉⲉⲩⲉ
ⲙⲉⲉⲩⲉ`	ⲙⲉⲉⲩⲉ
ⲙⲉⲗ̣ⲉⲧⲁ	ⲙⲉⲗⲉⲧⲁ
ⲙⲉⲗⲉⲧⲁ	ⲙⲉⲗⲉⲧⲁ
ⲙⲉⲗⲟⲥ	ⲙⲉⲗⲟⲥ
ⲙⲉⲛ⳿	ⲙⲉⲛ
ⲙⲉⲛ⳿	ⲙⲉⲛ
ⲙⲉⲛ	ⲙⲉⲛ
ⲙⲉⲛ	ⲙⲛ
ⲙⲉⲛ	ⲙⲉⲛ
ⲙⲉⲣⲉⲟⲩⲱϩ`	ⲙⲉⲣⲉⲟⲩⲱϩ
ⲙⲉⲣⲉ	ⲙⲉⲣⲉ
ⲙⲉⲣⲉ`	ⲙⲉⲣⲉ
ⲙⲉⲣⲓⲧ︤	ⲙⲉⲣⲓⲧ
ⲙⲉⲣⲓⲧ︤	ⲙⲉⲣⲓⲧ
ⲙⲉⲣⲓⲧ`	ⲙⲉⲣⲓⲧ
ⲙⲉⲣⲟⲥ⳿	ⲙⲉⲣⲟⲥ
ⲙⲉⲣⲟⲥ	ⲙⲉⲣⲟⲥ
ⲙⲉⲥⲟⲩⲁ⸍ⲫⲓ	ⲙⲉⲥⲟⲩⲁⲫⲓ
ⲙⲉⲥⲧⲱ	ⲙⲉⲥⲧⲱ
ⲙⲉⲧⲁⲛⲟⲉⲓ	ⲙⲉⲧⲁⲛⲟⲉⲓ
ⲙⲉⲧⲁⲛⲟⲓ̈	ⲙⲉⲧⲁⲛⲟⲉⲓ
ⲙⲉⲧⲁⲛⲟⲓ̈	ⲙⲉⲧⲁⲛⲟⲓ
ⲙⲉⲧⲁⲛⲟⲓⲁ	ⲙⲉⲧⲁⲛⲟⲓⲁ
ⲙⲉⲧⲁⲛⲟⲓ	ⲙⲉⲧⲁⲛⲟⲓ
ⲙⲉⲩⲧ	ⲙⲉⲩⲧ
ⲙⲉ⳯	ⲙⲉⲛ
ⲙⲉ⳿	ⲙⲉ
ⲙⲉ⳿	ⲙⲉ
ⲙⲉ	ⲙⲉ
ⲙⲉ	ⲙⲉ
ⲙⲉ	ⲙⲉ
ⲙⲉ`	ⲙⲉ
ⲙⲉ`	ⲙⲉ
ⲙⲏ̣	ⲙⲏ
ⲙⲏⲏϣⲉ	ⲙⲏⲏϣⲉ
ⲙⲏⲏϣⲉ`	ⲙⲏⲏϣⲉ
ⲙⲏⲙⲟⲟⲩ	ⲙⲏⲙⲟⲟⲩ
ⲙⲏⲛⲉ	ⲙⲏⲛⲉ
ⲙⲏⲡⲟⲧⲉ̇	ⲙⲏⲡⲟⲧⲉ
ⲙⲏⲡⲟⲧⲉ	ⲙⲏⲡⲟⲧⲉ
ⲙⲏⲧⲉ⳿	ⲙⲏⲧⲉ
ⲙⲏⲧⲉ	ⲙⲏⲧⲉ
ⲙⲏⲧⲉ`	ⲙⲏⲧⲉ
ⲙⲏⲧ	ⲙⲏⲧ
ⲙⲏ⳿	ⲙⲏ
ⲙⲏ	ⲙⲏ
ⲙⲏ`	ⲙⲏ
ⲙⲓ̇ⲗⲓ̇ⲟⲛ	ⲙⲓⲗⲓⲟⲛ
ⲙⲓϣⲉ	ⲙⲓϣⲉ
ⲙⲓϣⲉ	ⲙⲓϣⲉ
ⲙⲓⲛⲉ⳿	ⲙⲓⲛⲉ
ⲙⲓⲛⲉ	ⲙⲓⲛⲉ
ⲙⲓⲥⲉ`	ⲙⲓⲥⲉ
ⲙⲕⲁϩ	ⲙⲕⲁϩ
ⲙⲕⲁϩ	ⲙⲕⲁϩ
ⲙⲕⲁϩ`	ⲙⲕⲁϩ
ⲙⲙ̣[ⲟ	ⲙⲙⲟ
ⲙⲙⲁ̣ⲩ̣	ⲙⲙⲁⲩ
ⲙⲙⲁⲩ	ⲙⲙⲁⲩ
ⲙⲙⲏⲛⲉ	ⲙⲙⲏⲛⲉ
ⲙⲙⲓ̇ⲛⲙ̇ⲙⲟ	ⲙⲙⲓⲛⲙⲙⲟ
ⲙⲙⲟⲛ	ⲙⲙⲟⲛ
ⲙⲙⲟ	ⲙⲙⲟ
ⲙⲙⲟ	ⲙⲙⲟ
ⲙⲙ︤ⲛ︥	ⲙⲙⲛ
ⲙⲛ̄ⲧⲣⲉ	ⲙⲛⲧⲣⲉ
ⲙⲛ̄	ⲙⲛ
ⲙⲛ̄	ⲙⲛ
ⲙⲛ̇ⲧⲁ	ⲙⲛⲧⲁ
ⲙⲛ̇ⲧⲕⲁⲑⲁⲣⲟ̣[ⲥ]	ⲙⲛⲧⲕⲁⲑⲁⲣⲟⲥ
ⲙⲛ̇	ⲙⲛ
ⲙⲛ̇	ⲙⲛ
ⲙⲛ̣	ⲙⲛ
ⲙⲛⲧ̇ϩⲁⲣϣϩⲏ̇ⲧ	ⲙⲛⲧϩⲁⲣϣϩⲏⲧ
ⲙⲛⲧ̇ⲁ̇ⲡⲟⲧⲁⲕⲧⲓ̇ⲕⲟⲥ	ⲙⲛⲧⲁⲡⲟⲧⲁⲕⲧⲓⲕⲟⲥ
ⲙⲛⲧ̇ⲁ̇ⲧϩ̇ⲛⲁⲁ̇ⲁⲩ	ⲙⲛⲧⲁⲧϩⲛⲁⲁⲩ
ⲙⲛⲧ̇ⲙⲟⲛⲁⲭⲟⲥ	ⲙⲛⲧⲙⲟⲛⲁⲭⲟⲥ
ⲙⲛⲧ̇	ⲙⲛⲧ
ⲙⲛⲧϣⲁⲛϩⲧⲏ	ⲙⲛⲧϣⲁⲛϩⲧⲏ
ⲙⲛⲧϫⲁϫⲉ	ⲙⲛⲧϫⲁϫⲉ
ⲙⲛⲧϭⲁⲃϩⲏⲧ	ⲙⲛⲧϭⲁⲃϩⲏⲧ
ⲙⲛⲧⲁⲡⲓⲥⲧⲟⲥ	ⲙⲛⲧⲁⲡⲓⲥⲧⲟⲥ
ⲙⲛⲧⲣ̇ⲣⲟ	ⲙⲛⲧⲣⲣⲟ
ⲙⲛⲧⲣⲉϥϣⲙ̇ϣⲉⲛⲟⲩⲧⲉ	ⲙⲛⲧⲣⲉϥϣⲙϣⲉⲛⲟⲩⲧⲉ
ⲙⲛⲧⲥⲟϭ	ⲙⲛⲧⲥⲟϭ
ⲙⲛⲧⲥⲩⲛⲕ̇ⲗⲏⲧⲓ̇ⲕⲟ̇ⲥ	ⲙⲛⲧⲥⲩⲛⲕⲗⲏⲧⲓⲕⲟⲥ
ⲙⲛ︤ⲧ︥ⲁⲣⲅⲟⲥ	ⲙⲛⲧⲁⲣⲅⲟⲥ
ⲙⲛ︤ⲧ︥ⲛⲟⲩⲧⲉ	ⲙⲛⲧⲛⲟⲩⲧⲉ
ⲙⲛ︥	ⲙⲛ
ⲙⲛ︦ⲧ︥ⲁⲧⲥⲱⲧ︤ⲙ̣︥	ⲙⲛⲧⲁⲧⲥⲱⲧⲙ
ⲙⲛ	ⲙⲛ
ⲙⲛ	ⲙⲛ
ⲙⲟ̇ⲟϣⲉ	ⲙⲟⲟϣⲉ
ⲙⲟ̇ⲟⲩϣⲉ	ⲙⲟⲟⲩϣⲉ
ⲙⲟϣⲧ︤	ⲙⲟϣⲧ
ⲙⲟⲅⲓⲥ`	ⲙⲟⲅⲓⲥ
ⲙⲟⲓ̈Ϩⲉ	ⲙⲟⲓϩⲉ
ⲙⲟⲕϩ̄	ⲙⲟⲕϩ
ⲙⲟⲕϩ	ⲙⲟⲕϩ
ⲙⲟⲕⲙⲉⲕ	ⲙⲟⲕⲙⲉⲕ
ⲙⲟⲕ︤ϩ︥	ⲙⲟⲕϩ
ⲙⲟⲛⲁⲭⲟⲥ	ⲙⲟⲛⲁⲭⲟⲥ
ⲙⲟⲛⲕ	ⲙⲟⲛⲕ
ⲙⲟⲛⲟⲛ	ⲙⲟⲛⲟⲛ
ⲙⲟⲛⲟ⳯	ⲙⲟⲛⲟⲛ
ⲙⲟⲟ̇ϣⲉ	ⲙⲟⲟϣⲉ
ⲙⲟⲟϣⲉ	ⲙⲟⲟϣⲉ
ⲙⲟⲟϣⲉ`	ⲙⲟⲟϣⲉ
ⲙⲟⲟⲩⲧⲧ	ⲙⲟⲟⲩⲧ
ⲙⲟⲟⲩⲧ	ⲙⲟⲟⲩⲧ
ⲙⲟⲟⲩⲧ	ⲙⲟⲟⲩⲧ
ⲙⲟⲟⲩ	ⲙⲟⲟⲩ
ⲙⲟⲟⲩ	ⲟⲩ
ⲙⲟⲣⲫⲏ̂	ⲙⲟⲣⲫⲏ
ⲙⲟⲣⲫⲏ	ⲙⲟⲣⲫⲏ
ⲙⲟⲣⲫⲏ`	ⲙⲟⲣⲫⲏ
ⲙⲟⲥⲧⲉ	ⲙⲟⲥⲧⲉ
ⲙⲟⲥⲧⲉ	ⲙⲟⲥⲧⲉ
ⲙⲟⲥⲧⲉ`	ⲙⲟⲥⲧⲉ
ⲙⲟⲨⲧⲉ	ⲙⲟⲩⲧⲉ
ⲙⲟⲩ̣ⲓ̣	ⲙⲟⲩⲓ
ⲙⲟⲩϩ⳿	ⲙⲟⲩϩ
ⲙⲟⲩϩ	ⲙⲟⲩϩ
ⲙⲟⲩϩ`	ⲙⲟⲩϩ
ⲙⲟⲩⲓ̈	ⲙⲟⲩⲓ
ⲙⲟⲩⲟⲩⲧ	ⲙⲟⲩⲟⲩⲧ
ⲙⲟⲩⲟⲩⲧ`	ⲙⲟⲩⲟⲩⲧ
ⲙⲟⲩⲣ⳿	ⲙⲟⲩⲣ
ⲙⲟⲩⲣ	ⲙⲟⲩⲣ
ⲙⲟⲩⲥ	ⲙⲟⲩⲥ
ⲙⲟⲩⲧⲉ	ⲙⲟⲩⲧⲉ
ⲙⲟⲩⲧⲉ`	ⲙⲟⲩⲧⲉ
ⲙⲟⲩ	ⲙⲟⲩ
ⲙⲟⲩ	ⲙⲟⲩ
ⲙⲡ̣ϣ̣ⲁ̣	ⲙⲡϣⲁ
ⲙⲡϣⲁ	ⲙⲡϣⲁ
ⲙⲡⲉ	ⲙⲡⲉ
ⲙⲡ︤	ⲙⲡ
ⲙⲡ	ⲙⲡ
ⲙⲡ]	ⲙⲡ
ⲙⲧⲟ̂	ⲙⲧⲟ
ⲙⲧⲟⲛ`	ⲙⲧⲟⲛ
ⲙⲧⲟ	ⲙⲧⲟ
ⲙⲧⲟ`	ⲙⲧⲟ
ⲙⲩⲥⲧⲏⲣⲓ̈ⲟⲛ	ⲙⲩⲥⲧⲏⲣⲓⲟⲛ
ⲙⲱⲅⲓ̇ⲥ	ⲙⲱⲅⲓⲥ
ⲙⲱⲛⲟⲛ	ⲙⲱⲛⲟⲛ
ⲙⲱⲩ̈ⲥⲏⲥ	ⲙⲱⲩⲥⲏⲥ
ⲙ̣︤ⲛ̣︥	ⲙⲛ
ⲙ̣︤ⲛ̣︥	ⲙⲛ
ⲙ̣︤ⲛ︥	ⲙⲛ
ⲙ︤ⲕ︥ⲁϩ	ⲙⲕⲁϩ
ⲙ︤ⲛ̣︥	ⲙⲛ
ⲙ︤ⲛ̣︥	ⲙⲛ
ⲙ︤ⲛ︥ⲛ̄Ⲥⲁ	ⲙⲛⲛⲥⲁ
ⲙ︤ⲛ︥ⲛ̄ⲥⲁ	ⲙⲛⲛⲥⲁ
ⲙ︤ⲛ︥ⲧϩ︤ⲙ︥ϩⲁⲗ	ⲙⲛⲧϩⲙϩⲁⲗ
ⲙ︤ⲛ︥ⲧⲁ	ⲙⲛⲧⲁ
ⲙ︤ⲛ︥ⲧ	ⲙⲛⲧ
ⲙ︤ⲛ︥	ⲙⲛ
ⲙ︤ⲛ︥	ⲙⲛ
ⲙ︤ⲛ︥`	ⲙⲛ
ⲙ︤ⲛ︦ⲛ︥ⲥⲁ	ⲙⲛⲛⲥⲁ
ⲙ︤ⲛ︦ⲧϫⲁⲥⲓϩⲏⲧ	ⲙⲛⲧϫⲁⲥⲓϩⲏⲧ
ⲙ︤ⲛ︦ⲧⲃⲗⲗⲉ	ⲙⲛⲧⲃⲗⲗⲉ
ⲙ︤ⲛ︦ⲧ︥ϣⲁϥⲧⲉ	ⲙⲛⲧϣⲁϥⲧⲉ
ⲙ︤ⲛ︦ⲧ︥ϣⲁϥⲧⲉ	ⲙⲛⲧϣⲁϥⲧⲉ
ⲙ︤ⲛ︦ⲧ︥ϣⲁϥⲧⲉ`	ⲙⲛⲧϣⲁϥⲧⲉ
ⲙ︤ⲛ︦ⲧ︥ϣⲁⲛϩⲧⲏ	ⲙⲛⲧϣⲁⲛϩⲧⲏ
ⲙ︤ⲛ︦ⲧ︥ϣⲁⲩ	ⲙⲛⲧϣⲁⲩ
ⲙ︤ⲛ︦ⲧ︥ϣⲁ	ⲙⲛⲧϣⲁ
ⲙ︤ⲛ︦ⲧ︥ϣ︤ⲙ︥ⲙⲟ̂	ⲙⲛⲧϣⲙⲙⲟ
ⲙ︤ⲛ︦ⲧ︥ϩⲁϩ	ⲙⲛⲧϩⲁϩ
ⲙ︤ⲛ︦ⲧ︥ϩⲁⲡⲗⲟⲩⲥ	ⲙⲛⲧϩⲁⲡⲗⲟⲩⲥ
ⲙ︤ⲛ︦ⲧ︥ϩⲁⲣ︤ϣϩⲏⲧ︥	ⲙⲛⲧϩⲁⲣϣϩⲏⲧ
ⲙ︤ⲛ︦ⲧ︥ϩⲁⲣ︤ϣϩⲏⲧ`︥	ⲙⲛⲧϩⲁⲣϣϩⲏⲧ
ⲙ︤ⲛ︦ⲧ︥ϩⲏⲕⲉ	ⲙⲛⲧϩⲏⲕⲉ
ⲙ︤ⲛ︦ⲧ︥ϩ︤ⲗ︥ⲗⲟ	ⲙⲛⲧϩⲗⲗⲟ
ⲙ︤ⲛ︦ⲧ︥ϩ︤ⲗ︥ⲗⲱ̂	ⲙⲛⲧϩⲗⲗⲱ
ⲙ︤ⲛ︦ⲧ︥ϩ︤ⲙ︥ϩⲁⲗ	ⲙⲛⲧϩⲙϩⲁⲗ
ⲙ︤ⲛ︦ⲧ︥ϫⲁⲥⲓϩⲏⲧ	ⲙⲛⲧϫⲁⲥⲓϩⲏⲧ
ⲙ︤ⲛ︦ⲧ︥ϫⲁⲥⲓϩⲏⲧ`	ⲙⲛⲧϫⲁⲥⲓϩⲏⲧ
ⲙ︤ⲛ︦ⲧ︥ϫⲱⲱⲣⲉ	ⲙⲛⲧϫⲱⲱⲣⲉ
ⲙ︤ⲛ︦ⲧ︥ⲁⲅⲁⲑⲟⲥ`	ⲙⲛⲧⲁⲅⲁⲑⲟⲥ
ⲙ︤ⲛ︦ⲧ︥ⲁⲑⲏⲧ⳿	ⲙⲛⲧⲁⲑⲏⲧ
ⲙ︤ⲛ︦ⲧ︥ⲁⲑⲏⲧ`	ⲙⲛⲧⲁⲧϩⲏⲧ
ⲙ︤ⲛ︦ⲧ︥ⲁⲕⲁⲑⲁⲣⲧⲟⲥ⳿	ⲙⲛⲧⲁⲕⲁⲑⲁⲣⲧⲟⲥ
ⲙ︤ⲛ︦ⲧ︥ⲁⲡⲓⲥⲧⲟⲥ⳿	ⲙⲛⲧⲁⲡⲓⲥⲧⲟⲥ
ⲙ︤ⲛ︦ⲧ︥ⲁⲡⲟⲥⲧⲟⲥ⳿	ⲙⲛⲧⲁⲡⲟⲥⲧⲟⲥ
ⲙ︤ⲛ︦ⲧ︥ⲁⲣⲅⲟⲥ	ⲙⲛⲧⲁⲣⲅⲟⲥ
ⲙ︤ⲛ︦ⲧ︥ⲁⲧϩⲏⲧ	ⲙⲛⲧⲁⲧϩⲏⲧ
ⲙ︤ⲛ︦ⲧ︥ⲁⲧⲛⲟⲩⲧⲉ	ⲙⲛⲧⲁⲧⲛⲟⲩⲧⲉ
ⲙ︤ⲛ︦ⲧ︥ⲁⲧⲛⲟⲩⲧⲉ`	ⲙⲛⲧⲁⲧⲛⲟⲩⲧⲉ
ⲙ︤ⲛ︦ⲧ︥ⲁⲧⲥⲃⲱ̂	ⲙⲛⲧⲁⲧⲥⲃⲱ
ⲙ︤ⲛ︦ⲧ︥ⲁⲧⲥⲃⲱ̂`	ⲙⲛⲧⲁⲧⲥⲃⲱ
ⲙ︤ⲛ︦ⲧ︥ⲁⲧⲥⲃⲱ	ⲙⲛⲧⲁⲧⲥⲃⲱ
ⲙ︤ⲛ︦ⲧ︥ⲁⲧⲥⲟⲟⲩⲛ	ⲙⲛⲧⲁⲧⲥⲟⲟⲩⲛ
ⲙ︤ⲛ︦ⲧ︥ⲁⲧⲥⲟⲟⲩ⳯	ⲙⲛⲧⲁⲧⲥⲟⲟⲩⲛ
ⲙ︤ⲛ︦ⲧ︥ⲁⲧⲥⲱⲧⲙ̄	ⲙⲛⲧⲁⲧⲥⲱⲧⲙ
ⲙ︤ⲛ︦ⲧ︥ⲁⲧⲥⲱⲧ︤ⲙ︥	ⲙⲛⲧⲁⲧⲥⲱⲧⲙ
ⲙ︤ⲛ︦ⲧ︥ⲁ	ⲙⲛⲧⲁ
ⲙ︤ⲛ︦ⲧ︥ⲃⲁⲃⲉⲣⲱⲙⲉ	ⲙⲛⲧⲃⲁⲃⲉⲣⲱⲙⲉ
ⲙ︤ⲛ︦ⲧ︥ⲃⲁⲃⲉ`	ⲙⲛⲧⲃⲁⲃⲉ
ⲙ︤ⲛ︦ⲧ︥ⲉⲣⲟ̂	ⲙⲛⲧⲉⲣⲟ
ⲙ︤ⲛ︦ⲧ︥ⲉⲣⲟ`	ⲙⲛⲧⲉⲣⲟ
ⲙ︤ⲛ︦ⲧ︥ⲗⲏⲥⲧⲏⲥ⳿	ⲙⲛⲧⲗⲏⲥⲧⲏⲥ
ⲙ︤ⲛ︦ⲧ︥ⲙⲁⲓ̈	ⲙⲛⲧⲙⲁⲓ
ⲙ︤ⲛ︦ⲧ︥ⲙⲁⲓⲛⲟⲩⲧⲉ	ⲙⲛⲧⲙⲁⲓⲛⲟⲩⲧⲉ
ⲙ︤ⲛ︦ⲧ︥ⲛⲟⲩⲧⲉ	ⲙⲛⲧⲛⲟⲩⲧⲉ
ⲙ︤ⲛ︦ⲧ︥ⲡⲁⲣⲑⲉⲛⲟⲥ	ⲙⲛⲧⲡⲁⲣⲑⲉⲛⲟⲥ
ⲙ︤ⲛ︦ⲧ︥ⲣⲉϥ̣ϩⲓⲗⲁ	ⲙⲛⲧⲣⲉϥϩⲓⲗⲁ
ⲙ︤ⲛ︦ⲧ︥ⲣⲉϥϩⲉⲧⲃⲯⲩⲭⲏ	ⲙⲛⲧⲣⲉϥϩⲉⲧⲃⲯⲩⲭⲏ
ⲙ︤ⲛ︦ⲧ︥ⲣⲉϥϫⲓⲛϭⲟⲛ︤ⲥ︥	ⲙⲛⲧⲣⲉϥϫⲓⲛϭⲟⲛⲥ
ⲙ︤ⲛ︦ⲧ︥ⲣⲉϥϭ︤ⲛ︥	ⲙⲛⲧⲣⲉϥϭⲛ
ⲙ︤ⲛ︦ⲧ︥ⲣⲉϥϯϭⲱⲛ︤ⲧ︥	ⲙⲛⲧⲣⲉϥϯϭⲱⲛⲧ
ⲙ︤ⲛ︦ⲧ︥ⲣⲉϥⲧⲱϩ	ⲙⲛⲧⲣⲉϥⲧⲱϩ
ⲙ︤ⲛ︦ⲧ︥ⲣⲉϥⲧⲱϩ`	ⲙⲛⲧⲣⲉϥⲧⲱϩ
ⲙ︤ⲛ︦ⲧ︥ⲣ︤ⲙ︥ϩⲉ⳿	ⲙⲛⲧⲣⲙϩⲉ
ⲙ︤ⲛ︦ⲧ︥ⲣ︤ⲙ︥ϩⲉ	ⲙⲛⲧⲣⲙϩⲉ
ⲙ︤ⲛ︦ⲧ︥ⲥⲁⲃⲉ	ⲙⲛⲧⲥⲁⲃⲉ
ⲙ︤ⲛ︦ⲧ︥ⲥⲟϭ	ⲙⲛⲧⲥⲟϭ
ⲙ︤ⲛ︦ⲧ︥ⲥⲧⲙⲏⲧ	ⲙⲛⲧⲥⲧⲙⲏⲧ
ⲙ︤ⲛ︦ⲧ︥ⲧⲉ·ⲗⲓⲟⲥ	ⲙⲛⲧⲧⲉⲗⲓⲟⲥ
ⲙ︤ⲛ︦ⲧ︥`ⲛⲟⲩϫ`	ⲙⲛⲧⲛⲟⲩϫ
ⲙ︤ⲛ︦︦ⲧ︥ⲣ︤ⲙ︥ⲛ̄ϩⲏⲧ	ⲙⲛⲧⲣⲙⲛϩⲏⲧ
ⲙ︤ⲡ̣︥	ⲙⲡ
ⲙ︤	ⲙ
ⲙ︥ⲙⲁⲩ	ⲙⲙⲁⲩ
ⲙ︦ⲙⲟ	ⲙⲙⲟ
ⲙ︦ⲛ︦ⲧⲁⲡⲟⲥⲧⲟⲗⲟⲥ	ⲙⲛⲧⲁⲡⲟⲥⲧⲟⲗⲟⲥ
ⲙ︦ⲛ︦ⲧ︥ϩ︤ⲙ︥ϩⲁⲗ	ⲙⲛⲧϩⲙϩⲁⲗ
ⲙ︦ⲛ︦ⲧ︥ⲡⲣⲟⲇⲟⲧⲏⲥ	ⲙⲛⲧⲡⲣⲟⲇⲟⲧⲏⲥ
ⲙ	ⲙ
ⲙ	ⲙ
ⲙ	ⲙ
ⲙ[ⲙⲁⲩ	ⲙⲙⲁⲩ
ⲙ]ⲙ̣ⲁⲩ	ⲙⲙⲁⲩ
ⲙ]ⲛ	ⲙⲛ
Ⲛ̣̄	ⲛ
Ⲛ̄ⲁ	ⲛⲁ
Ⲛ̄ⲧⲟⲕ	ⲛⲧⲟⲕ
Ⲛ̄ⲧⲱⲧ︤ⲛ︥	ⲛⲧⲱⲧⲛ
Ⲛ̄ⲧ	ⲛⲧⲁ
Ⲛ̄ⲧ	ⲛⲧ
Ⲛ̄	ⲛ
Ⲛ̄	ⲛ
Ⲛ̄	ⲛ
Ⲛ̄	ⲛ
Ⲛϭⲓ̇	ⲛϭⲓ
Ⲛⲁϣⲱ	ⲛⲁϣⲱ
Ⲛⲁⲓ̈	ⲛⲁⲓ
Ⲛⲁⲓ	ⲛⲁⲓ
Ⲛⲁ	ⲛⲁ
Ⲛⲉ̇	ⲛⲉ
Ⲛⲉⲓ̇	ⲛⲉⲓ
Ⲛⲉ	ⲛⲉ
Ⲛⲓⲙ	ⲛⲓⲙ
Ⲛⲧⲟϥ	ⲛⲧⲟϥ
Ⲛⲧⲟⲟⲩ	ⲛⲧⲟⲟⲩ
Ⲛ	ⲛ
Ⲛ	ⲛ
ⲛ̀	ⲛ
ⲛ̣̄	ⲛ
ⲛ̣̄	ⲛ
ⲛ̣̄	ⲛ
ⲛ̣̄[ϭⲓ]	ⲛϭⲓ
ⲛ̄ϥⲓ	ⲛϥⲓ
ⲛ̄ϩⲏⲧ︤	ⲛϩⲏⲧ
ⲛ̄ϩⲏⲧ	ⲛϩⲏⲧ
ⲛ̄ϩⲟⲩⲛ	ⲛϩⲟⲩⲛ
ⲛ̄ϭⲓ	ⲛϭⲓ
ⲛ̄ϭ[ⲓ	ⲛϭⲓ
ⲛ̄ⲁ	ⲛⲁ
ⲛ̄ⲃ︤ⲗ︥ⲁ	ⲛⲃⲗⲁ
ⲛ̄ⲕⲁ⳿	ⲛⲕⲁ
ⲛ̄ⲕⲟⲧⲕ	ⲛⲕⲟⲧⲕ
ⲛ̄ⲕⲟⲧ︤ⲕ︥	ⲛⲕⲟⲧⲕ
ⲛ̄ⲛ̄	ⲛ
ⲛ̄ⲛ̣ⲁϩⲣⲁ	ⲛⲛⲁϩⲣⲁ
ⲛ̄ⲛ̣ⲉ	ⲛⲛⲉ
ⲛ̄ⲛⲁϩⲣⲛ̄	ⲛⲛⲁϩⲣⲛ
ⲛ̄ⲛⲁϩⲣ︤ⲙ︥	ⲛⲛⲁϩⲣⲙ
ⲛ̄ⲛⲁϩ︤ⲣ︦ⲛ︥	ⲛⲛⲁϩⲣⲛ
ⲛ̄ⲛⲉ	ⲛⲛⲉ
ⲛ̄ⲟⲩⲧⲉ	ⲛⲟⲩⲧⲉ
ⲛ̄ⲥⲁⲃⲏⲗ	ⲛⲥⲁⲃⲏⲗ
ⲛ̄ⲥⲁ	ⲛⲥⲁ
ⲛ̄ⲥⲱ̂	ⲛⲥⲱ
ⲛ̄ⲥⲱ	ⲛⲥⲱ
ⲛ̄Ⲧ	ⲛⲧ
ⲛ̄ⲧⲁ	ⲛⲧⲁ
ⲛ̄ⲧⲁ	ⲛⲧⲁ
ⲛ̄ⲧⲉⲣⲉ	ⲛⲧⲉⲣⲉ
ⲛ̄ⲧⲉⲣ	ⲛⲧⲉⲣ
ⲛ̄ⲧⲉⲧ︤ⲛ︥	ⲛⲧⲉⲧⲛ
ⲛ̄ⲧⲉ	ⲛⲧⲉ
ⲛ̄ⲧⲉ	ⲛⲧⲉ
ⲛ̄ⲧⲉ	ⲛⲧⲉ
ⲛ̄ⲧⲟϣ`	ⲛⲧⲟϣ
ⲛ̄ⲧⲟϥ	ⲛⲧⲟϥ
ⲛ̄ⲧⲟϥ`	ⲛⲧⲟϥ
ⲛ̄ⲧⲟⲕ	ⲛⲧⲟⲕ
ⲛ̄ⲧⲟⲟⲧ︤	ⲛⲧⲟⲟⲧ
ⲛ̄ⲧⲟⲟⲩⲛ	ⲛⲧⲟⲟⲩⲛ
ⲛ̄ⲧⲟⲟⲩ	ⲛⲧⲟⲟⲩ
ⲛ̄ⲧⲟⲟⲩ`	ⲛⲧⲟⲟⲩ
ⲛ̄ⲧⲟⲥ	ⲛⲧⲟⲥ
ⲛ̄ⲧⲟ	ⲛⲧⲟ
ⲛ̄ⲧⲱⲧ︤ⲛ︥	ⲛⲧⲱⲧⲛ
ⲛ̄ⲧⲱⲧ︤ⲛ︥`	ⲛⲧⲱⲧⲛ
ⲛ̄ⲧ︤ⲕ︥	ⲛⲧⲕ
ⲛ̄ⲧ	ⲛⲧ
ⲛ̄ⲧ	ⲉⲛⲧ
ⲛ̄ⲧ	ⲛⲧ
ⲛ̄ⲧ	ⲛ̄ⲧ
ⲛ̄ⲧ	ⲛⲧ
ⲛ̄	ⲛ
ⲛ̄	ⲛ
ⲛ̄	ⲛⲧ
ⲛ̄	ⲛ
ⲛ̄	ⲛ
ⲛ̄	ⲛ
ⲛ̄	ⲛ
ⲛ̄	ⲛ
ⲛ̄[.]ⲁ	ⲛⲥⲁ
ⲛ̄]	ⲛ
ⲛ̅	ⲛ
ⲛ̇ϣⲁ	ⲛϣⲁ
ⲛ̇ϫⲓ̇	ⲛϫⲓ
ⲛ̇ϭⲓ̇	ⲛϭⲓ
ⲛ̇ϭⲓ	ⲛϭⲓ
ⲛ̇ⲉⲛ	ⲛⲉⲛ
ⲛ̇ⲕⲟⲧⲕ̇	ⲛⲕⲟⲧⲕ
ⲛ̇ⲛⲉ	ⲛⲛⲉ
ⲛ̇ⲛ	ⲛ
ⲛ̇ⲥⲁ	ⲛⲥⲁ
ⲛ̇ⲥⲱ	ⲛⲥⲱ
ⲛ̇ⲧⲉⲣⲉ	ⲛⲧⲉⲣⲉ
ⲛ̇ⲧⲉⲣ	ⲛⲧⲉⲣ
ⲛ̇ⲧⲉ	ⲛⲧⲉ
ⲛ̇ⲧⲉ	ⲛⲧⲉ
ⲛ̇ⲧⲕ̇	ⲛⲧⲕ
ⲛ̇ⲧⲟϥ	ⲛⲧⲟϥ
ⲛ̇ⲧⲟϥ	ⲛⲧⲟⲕ
ⲛ̇ⲧⲟⲕ	ⲛⲧⲟⲕ
ⲛ̇ⲧⲟⲕ 	ⲛⲧⲟⲕ
ⲛ̇ⲧⲟⲗⲏ̇	ⲛⲧⲟⲗⲏ
ⲛ̇ⲧⲟⲟⲧ	ⲛⲧⲟⲟⲧ
ⲛ̇ⲧⲱⲧⲛ̇	ⲛⲧⲱⲧⲛ
ⲛ̇ⲧ	ⲛⲧ
ⲛ̇	ⲛ
ⲛ̇	ⲛ
ⲛ̇	ⲛ
ⲛ̇	ⲛ
ⲛ̇	ⲛ
ⲛ̇	ⲛ
ⲛ̇ 	ⲛ
ⲛ̣̄ⲣⲙ̣	ⲛⲣⲙ
ⲛ̣̄ⲧⲟϥ̣	ⲛⲧⲟϥ
ⲛ̣̄ⲧⲟⲟⲧ︤	ⲛⲧⲟⲟⲧ
ⲛ̣̄	ⲛ
ⲛ̣̄	ⲛ
ⲛ̣ⲁⲓ̈	ⲛⲁⲓ
ⲛ̣ⲁ	ⲛⲁ
ⲛ̣ⲁ	ⲛⲁ
ⲛ̣ⲉϥ	ⲛⲉϥ
ⲛ̣ⲉϩ	ⲛⲉϩ
ⲛ̣ⲉⲛ	ⲛⲉⲛ
ⲛ̣ⲉⲩ	ⲛⲉⲩ
ⲛ̣ⲉ	ⲛⲉ
ⲛ̣ⲉ	ⲛⲉ
ⲛ̣ⲏ̣	ⲛⲏ
ⲛ̣ⲏ	ⲛⲏ
ⲛ̣ⲓ̣ⲙ̣	ⲛⲓⲙ
ⲛ̣ⲓⲙ̣	ⲛⲓⲙ
ⲛ̣ⲛ̣ⲉ	ⲛⲛⲉ
ⲛ̣ⲟϭ	ⲛⲟϭ
ⲛ̣ⲟⲩⲧⲉ	ⲛⲟⲩⲧⲉ
ⲛ̣ⲧ̣	ⲛⲧ
ⲛ̣ⲧⲁ̣	ⲛⲧⲁ
ⲛ̣︥	ⲛ
ⲛ̣	ⲛ
ⲛ̣	ⲛ
ⲛ̣	ⲛ
ⲛ̣	ⲛ
ⲛ̣	ⲛ
ⲛ̣[ϩⲏ]ⲧ	ⲛϩⲏⲧ
ⲛ̣[ⲉ	ⲛⲉ
ⲛϩⲏⲧ︤	ⲛϩⲏⲧ
ⲛϩⲏⲧ	ⲛϩⲏⲧ
ⲛϩⲏ[ⲧ]	ⲛϩⲏⲧ
ⲛϭ̣ⲓ̣	ⲛϭⲓ
ⲛϭⲓ̇	ⲛϭⲓ
ⲛϭⲓ	ⲛϭⲓ
ⲛⲁ̣	ⲛⲁ
ⲛⲁϣⲉ	ⲛⲁϣⲉ
ⲛⲁϣⲧ	ⲛⲁϣⲧ
ⲛⲁϣⲱ	ⲛⲁϣⲱ
ⲛⲁϩⲙ	ⲛⲁϩⲙ
ⲛⲁϩⲣⲁ	ⲛⲁϩⲣⲁ
ⲛⲁϩⲣ︤ⲛ︥	ⲛⲁϩⲣⲛ
ⲛⲁϩ︤ⲣ︦ⲛ︥	ⲛⲁϩⲣⲛ
ⲛⲁⲃⲟⲩⲭⲟⲇⲟⲛⲟ̂ⲥⲟⲣ⳿	ⲛⲁⲃⲟⲩⲭⲟⲇⲟⲛⲟⲥⲟⲣ
ⲛⲁⲓ̇	ⲛⲁⲓ
ⲛⲁⲓ̣̈	ⲛⲁⲓ
ⲛⲁⲓ̈ⲁⲧ	ⲛⲁⲓⲁⲧ
ⲛⲁⲓ̈	ⲛⲁⲓ
ⲛⲁⲓ	ⲛⲁⲓ
ⲛⲁⲙⲉ⳿	ⲛⲁⲙⲉ
ⲛⲁⲙⲉ	ⲛⲁⲙⲉ
ⲛⲁⲙⲉ`	ⲛⲁⲙⲉ
ⲛⲁⲛ̣ⲉ	ⲛⲁⲛⲉ
ⲛⲁⲛⲟⲩ	ⲛⲁⲛⲟⲩ
ⲛⲁⲛ	ⲛⲁⲛⲟⲩ
ⲛⲁⲩ	ⲛⲁⲩ
ⲛⲁⲩ	ⲛⲁⲩ
ⲛⲁⲩ`	ⲛⲁⲩ
ⲛⲁⲩ`	ⲛⲁⲩ
ⲛⲁ⳿	ⲛⲁ
ⲛⲁ⳿	ⲛⲁ
ⲛⲁ⳿	ⲛⲁ
ⲛⲁ	ⲛⲁ
ⲛⲁ	ⲛⲁ
ⲛⲁ	ⲛⲁ
ⲛⲁ	ⲛⲁ
ⲛⲁ	ⲛⲁ
ⲛⲁ	ⲛⲁ
ⲛⲁ]	ⲛⲁ
ⲛⲁ`	ⲛⲁ
ⲛⲉϥ	ⲛⲉϥ
ⲛⲉϩ⳿	ⲛⲉϩ
ⲛⲉϩ`	ⲛⲉϩ
ⲛⲉϫⲕⲁϩ	ⲛⲉϫⲕⲁϩ
ⲛⲉϫ	ⲛⲉϫ
ⲛⲉⲓ̇	ⲛⲉⲓ
ⲛⲉⲓ̈	ⲛⲉⲓ
ⲛⲉⲓ	ⲛⲉⲓ
ⲛⲉⲕ⳿	ⲛⲉⲕ
ⲛⲉⲕ	ⲛⲉⲕ
ⲛⲉⲛ	ⲛⲉⲛ
ⲛⲉⲣⲉ	ⲛⲉⲣⲉ
ⲛⲉⲣ	ⲛⲉⲣ
ⲛⲉⲧⲛ̄	ⲛⲉⲧⲛ
ⲛⲉⲧⲛ̇	ⲛⲉⲧⲛ
ⲛⲉⲧⲛ︥	ⲛⲉⲧⲛ
ⲛⲉⲧⲛ	ⲛⲉⲧⲛ
ⲛⲉⲧ︤ⲛ︥	ⲛⲉⲧⲛ
ⲛⲉⲧ︤ⲛ︥	ⲛⲉⲧⲛ
ⲛⲉⲧ	ⲛⲉⲧ
ⲛⲉⲧ`	ⲛⲉⲧ
ⲛⲉⲩ	ⲛⲉⲩ
ⲛⲉ⳯	ⲛⲉⲛ
ⲛⲉ⳿	ⲛⲉ
ⲛⲉ	ⲛⲉ
ⲛⲉ	ⲛⲉ
ⲛⲉ	ⲛⲉ
ⲛⲉ	ⲛⲉ
ⲛⲉ	ⲛⲉ
ⲛⲉ]ⲛ	ⲛⲉⲛ
ⲛⲉ]	ⲛⲉ
ⲛⲉ`	ⲛⲉ
ⲛⲉ`	ⲛⲉ
ⲛⲏ̂	ⲛⲏ
ⲛⲏϫ	ⲛⲏϫ
ⲛⲏⲥⲧⲓⲁ⳿	ⲛⲏⲥⲧⲉⲓⲁ
ⲛⲏⲥⲧⲓⲁ	ⲛⲏⲥⲧⲉⲓⲁ
ⲛⲏⲩ	ⲛⲏⲩ
ⲛⲏⲩ	ⲛⲏⲩ
ⲛⲏⲫⲉ	ⲛⲏⲫⲉ
ⲛⲏ	ⲛⲏ
ⲛⲓ̇ⲙ	ⲛⲓⲙ
ⲛⲓ̈ⲙ	ⲛⲓⲙ
ⲛⲓϥⲉ`	ⲛⲓϥⲉ
ⲛⲓⲙ̣	ⲛⲓⲙ
ⲛⲓⲙ⳿	ⲛⲓⲙ
ⲛⲓⲙ	ⲛⲓⲙ
ⲛⲓⲙ`	ⲛⲓⲙ
ⲛⲓ	ⲛⲉⲓ
ⲛⲓ	ⲛⲓ
ⲛⲕⲁ	ⲛⲕⲁ
ⲛⲙ̇ⲙⲁ	ⲛⲙⲙⲁ
ⲛⲙⲙⲁ	ⲛⲙⲙⲁ
ⲛⲙ︥ⲙⲁ	ⲛⲙⲙⲁ
ⲛⲛⲉ	ⲛⲛⲉ
ⲛⲟ̣ϭ	ⲛⲟϭ
ⲛⲟϥⲣⲉ`	ⲛⲟϥⲣⲉ
ⲛⲟϫ︤	ⲛⲟϫ
ⲛⲟϫ	ⲛⲟϫ
ⲛⲟϭⲛⲉϭ	ⲛⲟϭⲛⲉϭ
ⲛⲟϭ	ⲛⲟϭ
ⲛⲟⲃⲉ	ⲛⲟⲃⲉ
ⲛⲟⲃⲉ`	ⲛⲟⲃⲉ
ⲛⲟⲏ̂`	ⲛⲟⲏ
ⲛⲟⲓ̈	ⲛⲟⲓ
ⲛⲟⲙⲟⲥ	ⲛⲟⲙⲟⲥ
ⲛⲟⲙⲟⲥ`	ⲛⲟⲙⲟⲥ
ⲛⲟⲩϥ	ⲛⲟⲩϥ
ⲛⲟⲩϫⲉ⳿	ⲛⲟⲩϫⲉ
ⲛⲟⲩϫⲉ	ⲛⲟⲩϫⲉ
ⲛⲟⲩϫ	ⲛⲟⲩϫ
ⲛⲟⲩϫ	ⲛⲟⲩϫ
ⲛⲟⲩϫ`	ⲛⲟⲩϫ
ⲛⲟⲩϭⲥ	ⲛⲟⲩϭⲥ
ⲛⲟⲩϭ︤ⲥ︥	ⲛⲟⲩϭⲥ
ⲛⲟⲩϭ︤ⲥ︥	ⲛⲟⲩϭⲥ
ⲛⲟⲩⲃ	ⲛⲟⲩⲃ
ⲛⲟⲩⲕ	ⲛⲟⲩⲕ
ⲛⲟⲩⲛⲉ⳿	ⲛⲟⲩⲛⲉ
ⲛⲟⲩⲛⲉ	ⲛⲟⲩⲛⲉ
ⲛⲟⲩⲧⲉ⳿	ⲛⲟⲩⲧⲉ
ⲛⲟⲩⲧⲉ	ⲛⲟⲩⲧⲉ
ⲛⲟⲩⲧⲉ`	ⲛⲟⲩⲧⲉ
ⲛⲟⲩ	ⲛⲟⲩ
ⲛⲟⲩ	ⲛⲟⲩ
ⲛⲟⲩ	ⲛⲟⲩ
ⲛⲟⲩ[ⲃ	ⲛⲟⲩⲃ
ⲛⲟⲩ[ⲧⲉ]	ⲛⲟⲩⲧⲉ
ⲛⲟⲩ]ⲧⲉ	ⲛⲟⲩⲧⲉ
ⲛⲥⲁ⳿	ⲛⲥⲁ
ⲛⲥⲁ	ⲛⲥⲁ
ⲛⲦ	ⲛⲧ
ⲛⲧⲁ	ⲛⲧⲁ
ⲛⲧⲉⲣ	ⲛⲧⲉⲣ
ⲛⲧⲉ	ⲛⲧⲉ
ⲛⲧⲉ	ⲛⲧⲉ
ⲛⲧⲟϥ	ⲛⲧⲟϥ
ⲛⲧⲟⲟⲧ	ⲛⲧⲟⲟⲧ
ⲛⲧⲟⲟⲩⲛ	ⲛⲧⲟⲟⲩⲛ
ⲛⲧⲟⲟⲩ	ⲛⲧⲟⲟⲩ
ⲛⲧⲟⲟⲩ	ⲛⲧⲟⲟⲩ
ⲛⲧ	ⲛⲧ
ⲛⲧ	ⲛⲧ
ⲛⲩⲕⲧⲉⲣⲓⲥ	ⲛⲩⲕⲧⲉⲣⲓⲥ
ⲛⲩⲕⲧⲉⲣⲓⲥ`	ⲛⲩⲕⲧⲉⲣⲓⲥ
ⲛ⳯	ⲛⲉⲛ
ⲛ⳿	ⲛ
ⲛ︤ⲅ︥ⲥⲟⲧ	ⲥⲟⲧ
ⲛ︤ⲙ︥ⲙⲁ	ⲛⲙⲙⲁ
ⲛ︤ⲙ︥ⲙⲏ	ⲛⲙⲙⲏ
ⲛ︤ⲙ︥ⲙ	ⲛⲙⲙ
ⲛ︤ⲙ︥ⲙ	ⲛⲙⲙ
ⲛ︤ⲧ︥	ⲛⲧ
ⲛ︤	ⲛ
ⲛ︤	ⲛ
ⲛ︤	ⲛ
ⲛ︤	ⲛ
ⲛ︥ϩⲏⲧ︤	ⲛϩⲏⲧ
ⲛ︥ϩⲏⲧ	ⲛϩⲏⲧ
ⲛ︥ⲕⲟⲧ︤ⲕ︥	ⲛⲕⲟⲧⲕ
ⲛ︥	ⲛ
ⲛ︥	ⲛ
ⲛ︥	ⲛ
ⲛ︥	ⲛ
ⲛ︥	ⲛ
ⲛ︥`	ⲛ
ⲛ︥`	ⲛ
ⲛ	ⲛ
ⲛ	ⲛⲉ
ⲛ	ⲛ
ⲛ	ⲛ
ⲛ	ⲛ
ⲛ	ⲛ
ⲛ	ⲛ
ⲛ	ⲛ
ⲛ ́ 	ⲛ
ⲛ 	ⲛ
ⲛ[ϭ]ⲓ	ⲛϭⲓ
ⲛ]	ⲛ
ⲛ]	ⲛ
ⲛ`	ⲛ
ⲛ`	ⲛ
ⲛ`	ⲛ
ⲛ`	ⲛ
ⲛ`	ⲛ
ⲛ`	ⲛ
Ⲟⲛ⳿	ⲟⲛ
Ⲟⲛ	ⲟⲛ
Ⲟⲩ̣	ⲟⲩ
Ⲟⲩⲟⲓ̈	ⲟⲩⲟⲓ
Ⲟⲩⲟⲛ	ⲟⲩⲟⲛ
Ⲟⲩ	ⲟⲩ
ⲟ̂ⲃ︤ϣ︥	ⲟⲃϣ
ⲟ̂ⲉⲓⲕ⳿	ⲟⲉⲓⲕ
ⲟ̂	ⲟ
ⲟ̇ⲃⲉ	ⲟⲃⲉ
ⲟ̇ⲉⲓ̇ϣ	ⲟⲉⲓϣ
ⲟ̇ⲉⲓ̇ⲕ	ⲟⲉⲓⲕ
ⲟ̇ⲛ	ⲟⲛ
ⲟ̇ⲥⲉ	ⲟⲥⲉ
ⲟ̇ⲧⲡ̇	ⲟⲧⲡ
ⲟ̣ⲩ̣	ⲟⲩ
ⲟ̣ⲩ̣	ⲟⲩ
ⲟ̣ⲩⲁ`	ⲟⲩⲁ
ⲟ̣ⲩ	ⲟⲩ
ⲟ̣`	ⲟ
ⲟϣⲉ̣	ⲟϣⲉ
ⲟϣ⳿	ⲟϣ
ⲟϣ	ⲟϣ
ⲟϣ	ⲟϣ
ⲟϭⲉ	ⲟϭⲉ
ⲟ᷍ⲩ	ⲟⲩ
ⲟ᷍ⲩ	ⲟⲩ
ⲟ᷍ⲩ	ⲟⲩ
ⲟⲇⲟⲗⲗⲁ`	ⲟⲇⲟⲗⲗⲁ
ⲟⲉⲓⲉ⳿	ⲟⲉⲓⲉ
ⲟⲉⲓⲕ	ⲟⲉⲓⲕ
ⲟⲓ̈	ⲟⲓ
ⲟⲓ̈	ⲟⲓ
ⲟⲓⲕⲟⲛⲟⲙⲟⲥ⳿	ⲟⲓⲕⲟⲛⲟⲙⲟⲥ
ⲟⲓⲕⲟⲩⲙⲉⲛⲏ⳿	ⲟⲓⲕⲟⲩⲙⲉⲛⲏ
ⲟⲓⲕⲟⲩⲙⲉⲛⲏ	ⲟⲓⲕⲟⲩⲙⲉⲛⲏ
ⲟⲓⲕⲟⲩⲙⲉⲛⲏ`	ⲟⲓⲕⲟⲩⲙⲉⲛⲏ
ⲟⲛ̄	ⲟⲛ
ⲟⲛϩ̣	ⲟⲛϩ
ⲟⲛϩ	ⲟⲛϩ
ⲟⲛ⳿	ⲟⲛ
ⲟⲛ︤ϩ︥	ⲟⲛϩ
ⲟⲛ	ⲟⲛ
ⲟⲛ`	ⲟⲛ
ⲟⲟϩ⳿	ⲟⲟϩ
ⲟⲟⲧⲉ`	ⲟⲟⲧⲉ
ⲟⲟⲩ	ϩⲟⲟⲩ
ⲟⲟⲩ	ⲟⲟⲩ
ⲟⲟⲩ	ϩⲟⲟⲩ
ⲟⲟⲩ`	ϩⲟⲟⲩ
ⲟⲟⲩ`	ⲟⲟⲩ
ⲟⲣⲅⲏ̂`	ⲟⲣⲅⲏ
ⲟⲣⲅⲏ⳿	ⲟⲣⲅⲏ
ⲟⲣⲅⲏ	ⲟⲣⲅⲏ
ⲟⲣⲅⲏ`	ⲟⲣⲅⲏ
ⲟⲣⲪⲁⲛⲟⲥ	ⲟⲣⲫⲁⲛⲟⲥ
ⲟⲣⲫⲁⲛⲟⲥ⳿	ⲟⲣⲫⲁⲛⲟⲥ
ⲟⲧⲉ	ϩⲟⲧⲉ
ⲟⲧⲉ`	ϩⲟⲧⲉ
ⲟⲩ̂	ⲟⲩ
ⲟⲩ̇ⲱ̇ϩ	ⲟⲩⲱⲙ
ⲟⲩ̇	ⲟⲩ
ⲟⲩ̣	ⲟⲩ
ⲟⲩ̣	ⲟⲩ
ⲟⲩ̣	ⲟⲩ
ⲟⲩϣⲏ	ⲟⲩϣⲏ
ⲟⲩϫⲁⲓ̇	ⲟⲩϫⲁⲓ
ⲟⲩϫⲁⲓ̈	ⲟⲩϫⲁⲓ
ⲟⲩϫⲁⲓ̈	ⲟⲩϫⲁⲓ
ⲟⲩϯ	ⲟⲩϯ
ⲟⲩⲁ̂	ⲟⲩⲁ
ⲟⲩⲁ̇ⲁⲃ	ⲟⲩⲁⲁⲃ
ⲟⲩⲁ̇	ⲟⲩⲁ
ⲟⲩⲁϣ︤	ⲟⲩⲁϣ
ⲟⲩⲁϩⲙ	ⲟⲩⲁϩⲙ
ⲟⲩⲁϩ︤	ⲟⲩⲁϩ
ⲟⲩⲁϩ	ⲟⲩⲁϩ
ⲟⲩⲁⲁⲃ⳿	ⲟⲩⲁⲁⲃ
ⲟⲩⲁⲁⲃ	ⲟⲩⲁⲁⲃ
ⲟⲩⲁⲁⲃ`	ⲟⲩⲁⲁⲃ
ⲟⲩⲁⲁ	ⲟⲩⲁⲁ
ⲟⲩⲁ⳿	ⲟⲩⲁ
ⲟⲩⲁ	ⲟⲩⲁ
ⲟⲩⲁ	ⲟⲩⲁ
ⲟⲩⲁ`	ⲟⲩⲁ
ⲟⲩⲃⲁϣ	ⲟⲩⲃⲁϣ
ⲟⲩⲃⲉ	ⲟⲩⲃⲉ
ⲟⲩⲃⲏ	ⲟⲩⲃⲏ
ⲟⲩⲇ̣ⲉ	ⲟⲩⲇⲉ
ⲟⲩⲇⲉ	ⲟⲩⲇⲉ
ⲟⲩⲇ[.......]	ⲟⲩⲇ[.......]
ⲟⲩⲉϣϫⲱⲕ︤ⲙ︥	ⲟⲩⲉϣϫⲱⲕⲙ
ⲟⲩⲉϣ	ⲟⲩⲉϣ
ⲟⲩⲉϣ	ⲟⲩⲉϣ
ⲟⲩⲉϩ	ⲟⲩⲉϩ
ⲟⲩⲉϭⲣⲟ̂	ⲟⲩⲉϭⲣⲟ
ⲟⲩⲉⲓ̂	ⲟⲩⲉⲓ
ⲟⲩⲉⲓ	ⲟⲩⲉⲓ
ⲟⲩⲉⲣⲏⲧⲉ	ⲟⲩⲉⲣⲏⲧⲉ
ⲟⲩⲉ	ⲟⲩⲉ
ⲟⲩⲉ`	ⲟⲩⲉ
ⲟⲩⲏ̇ϩ	ⲟⲩⲏϩ
ⲟⲩⲏ̇ⲣ	ⲟⲩⲏⲣ
ⲟⲩⲏϩ⳿	ⲟⲩⲏϩ
ⲟⲩⲏϩ	ⲟⲩⲏϩ
ⲟⲩⲏϩ`	ⲟⲩⲏϩ
ⲟⲩⲏⲏⲃ`	ⲟⲩⲏⲏⲃ
ⲟⲩⲏⲣ	ⲟⲩⲏⲣ
ⲟⲩⲏⲣ	ⲟⲩⲏⲣ
ⲟⲩⲏⲣ`	ⲟⲩⲏⲣ
ⲟⲩⲏⲩ	ⲟⲩⲏⲩ
ⲟⲩⲏⲩ`	ⲟⲩⲏⲩ
ⲟⲩⲕ	ⲟⲩⲕ
ⲟⲩⲛ̄ⲧⲁ	ⲟⲩⲛⲧⲁ
ⲟⲩⲛ̄ⲧⲉ	ⲟⲩⲛⲧⲉ
ⲟⲩⲛ̄ⲧⲏ	ⲟⲩⲛⲧⲏ
ⲟⲩⲛ̄ⲧ︤	ⲟⲩⲛⲧ
ⲟⲩⲛ̄ⲧ	ⲟⲩⲛⲧ
ⲟⲩⲛ̄	ⲟⲩⲛ
ⲟⲩⲛ̇ⲧⲁ	ⲟⲩⲛⲧⲁ
ⲟⲩⲛ̇	ⲟⲩⲛ
ⲟⲩⲛϩ	ⲟⲩⲏϩ
ⲟⲩⲛⲧⲁ	ⲟⲩⲛⲧⲁ
ⲟⲩⲛ	ⲟⲩⲛ
ⲟⲩⲛ	ⲟⲩⲛ
ⲟⲩⲟ̂ⲉⲓϣ	ⲟⲩⲟⲉⲓϣ
ⲟⲩⲟ̂ⲛ	ⲟⲩⲟⲛ
ⲟⲩⲟ̇ⲉⲓ̇ϣ	ⲟⲩⲟⲉⲓϣ
ⲟⲩⲟ̇ⲙ	ⲟⲩⲟⲙ
ⲟⲩⲟ̇ⲛ	ⲟⲩⲟⲛ
ⲟⲩⲟ̣ⲛ	ⲟⲩⲟⲛ
ⲟⲩⲟϭ︤ⲡ︥	ⲟⲩⲟϭⲡ
ⲟⲩⲟⲉ̣ⲓ̣ϣ	ⲟⲩⲟⲉⲓϣ
ⲟⲩⲟⲉⲓ̇ϣ	ⲟⲩⲟⲉⲓϣ
ⲟⲩⲟⲉⲓ̈ϣ	ⲟⲩⲟⲉⲓϣ
ⲟⲩⲟⲉⲓ̣ϣ	ⲟⲩⲟⲉⲓϣ
ⲟⲩⲟⲉⲓϣ̣	ⲟⲩⲟⲉⲓϣ
ⲟⲩⲟⲉⲓϣ	ⲟⲩⲟⲉⲓϣ
ⲟⲩⲟⲉⲓϣ`	ⲟⲩⲟⲉⲓϣ
ⲟⲩⲟⲉⲓⲛ	ⲟⲩⲟⲉⲓⲛ
ⲟⲩⲟⲉⲓⲛ`	ⲟⲩⲟⲉⲓⲛ
ⲟⲩⲟⲓ̈ϣ	ⲟⲩⲟⲓⲉϣ
ⲟⲩⲟⲓ̈	ⲟⲩⲟⲓ
ⲟⲩⲟⲓ̈	ⲟⲩⲟⲓ
ⲟⲩⲟⲓⲉϣ	ⲟⲩⲟⲓⲉϣ
ⲟⲩⲟⲗ︤ⲥ︥	ⲟⲩⲟⲗⲥ
ⲟⲩⲟⲛ︤ϩ︥	ⲟⲩⲟⲛϩ
ⲟⲩⲟⲛ	ⲟⲩⲟⲛ
ⲟⲩⲟⲛ`	ⲟⲩⲟⲛ
ⲟⲩⲟⲩⲟ̇ⲉⲓ̇ϣ	ⲟⲩⲟⲉⲓϣ
ⲟⲩⲣⲟⲧ	ⲟⲩⲣⲟⲧ
ⲟⲩⲥⲓⲁ	ⲟⲩⲥⲓⲁ
ⲟⲩⲧⲃⲁ`	ⲟⲩⲧⲃⲁ
ⲟⲩⲧⲉ	ⲟⲩⲧⲉ
ⲟⲩⲰϣ`	ⲟⲩⲱϣ
ⲟⲩⲱ̂ϣ︤ⲧ︥	ⲟⲩⲱϣⲧ
ⲟⲩⲱ̂ϭ︤ⲡ︥	ⲟⲩⲱϭⲡ
ⲟⲩⲱ̂ⲧ︤ⲛ︥	ⲟⲩⲱⲧⲛ
ⲟⲩⲱ̇ϣⲃ̇	ⲟⲩⲱϣⲃ
ⲟⲩⲱ̇ϣⲃ	ⲟⲩⲱϣⲃ
ⲟⲩⲱ̇ϣ	ⲟⲩⲱϣ
ⲟⲩⲱ̇ϣ	ⲟⲩⲱϣ
ⲟⲩⲱ̇ⲙ	ⲟⲩⲱⲙ
ⲟⲩⲱ̇ⲛ	ⲟⲩⲱⲛ
ⲟⲩⲱ̇ⲧ	ⲟⲩⲱⲧ
ⲟⲩⲱϣ̇ⲃ	ⲟⲩⲱϣⲃ
ⲟⲩⲱϣⲃ̇	ⲟⲩⲱϣⲃ
ⲟⲩⲱϣⲃ	ⲟⲩⲱϣⲃ
ⲟⲩⲱϣ︤ⲃ︥	ⲟⲩⲱϣⲃ
ⲟⲩⲱϣ	ⲟⲩⲱϣ
ⲟⲩⲱϣ	ⲟⲩⲱϣ
ⲟⲩⲱϣ`	ⲟⲩⲱϣ
ⲟⲩⲱϣ`	ⲟⲩⲱϣ
ⲟⲩⲱϩ⳿	ⲟⲩⲱϩ
ⲟⲩⲱϩ︤ⲙ̣︥	ⲟⲩⲱϩⲙ
ⲟⲩⲱϩ	ⲟⲩⲱϩ
ⲟⲩⲱⲙ⳿	ⲟⲩⲱⲙ
ⲟⲩⲱⲙ	ⲟⲩⲱⲙ
ⲟⲩⲱⲛϣ̄	ⲟⲩⲱⲛϣ
ⲟⲩⲱⲛϩ̄	ⲟⲩⲱⲛϩ
ⲟⲩⲱⲛ︤ϣ︥	ⲟⲩⲱⲛϣ
ⲟⲩⲱⲛ︤ϩ︥	ⲟⲩⲱⲛϩ
ⲟⲩⲱⲛ	ⲟⲩⲱⲛ
ⲟⲩⲱⲧⲃ̇	ⲟⲩⲱⲧⲃ
ⲟⲩⲱⲧ⳿	ⲟⲩⲱⲧ
ⲟⲩⲱⲧ	ⲟⲩⲱⲧ
ⲟⲩⲱⲧ`	ⲟⲩⲱⲧ
ⲟⲩ⳿	ⲟⲩ
ⲟⲩ⳿	ⲟⲩ
ⲟⲩ	ⲟⲩ
ⲟⲩ	ⲟⲩ
ⲟⲩ	ⲟⲩ
ⲟⲩ	ⲟⲩ
ⲟⲩ	ⲟⲩ
ⲟⲩ	ⲟⲩ
ⲟⲩ 	ⲟⲩ
ⲟⲩ[ⲁⲁⲃ]	ⲟⲩⲁⲁⲃ
ⲟⲩ]	ⲟⲩ
ⲟⲩ]	ⲟⲩ
ⲟⲩ`	ⲟⲩ
ⲟⲩ`	ⲟⲩ
ⲟ⳿	ⲟ
ⲟ	ⲟ
ⲟ ̂ⲩ	ⲟⲩ
ⲟ ̂ⲩ	ⲟⲩ
ⲟ]ⲩ̣ⲁⲁⲃ	ⲟⲩⲁⲁⲃ
ⲟ]ⲩ	ⲟⲩ
ⲟ`	ⲟ
Ⲡⲁⲓ̇	ⲡⲁⲓ
Ⲡⲁⲓ̈	ⲡⲁⲓ
Ⲡⲁⲓ	ⲡⲁⲓ
Ⲡⲁⲗⲓⲛ	ⲡⲁⲗⲓⲛ
Ⲡⲁ	ⲡⲁ
Ⲡⲉϫⲁ	ⲡⲉϫⲁ
Ⲡⲉϫⲉ	ⲡⲉϫⲉ
Ⲡⲗⲏⲛ⳿	ⲡⲗⲏⲛ
Ⲡⲗⲏⲛ	ⲡⲗⲏⲛ
Ⲡ	ⲡ
ⲡ̣̇	ⲡ
ⲡ̇ⲉⲓ̇	ⲡⲉⲓ
ⲡ̇ⲟⲗⲓ̇ⲥ̣	ⲡⲟⲗⲓⲥ
ⲡ̇	ⲡ
ⲡ̣ⲁⲓ̈	ⲡⲁⲓ
ⲡ̣ⲁⲣⲁⲃⲁ	ⲡⲁⲣⲁⲃⲁ
ⲡ̣ⲉ̣	ⲡⲉ
ⲡ̣ⲉⲛ	ⲡⲉⲛ
ⲡ̣ⲉⲩ	ⲡⲉⲩ
ⲡ̣ⲉ	ⲡⲉ
ⲡ̣ⲉ	ⲡⲉ
ⲡ̣ⲏⲧ	ⲡⲏⲧ
ⲡ̣ⲟⲟⲩ	ⲡⲟⲟⲩ
ⲡ̣︤ⲣ︤︥ϣ̣︥	ⲡⲣϣ
ⲡ̣	ⲡ
ⲡ̣[…]ⲡⲟⲥ	ⲡ̣[…]ⲡⲟⲥ
ⲡⲁ̇ⲡⲛⲟⲩⲧⲉ	ⲡⲁⲡⲛⲟⲩⲧⲉ
ⲡⲁ̇ⲥⲧⲁⲙⲱⲛ	ⲡⲁⲥⲧⲁⲙⲱⲛ
ⲡⲁ̣[…]ϥⲟϭⲉ`	ⲡⲁ[…]ϥⲟϭⲉ
ⲡⲁϣⲉ	ⲡⲁϣⲉ
ⲡⲁϩⲟ	ⲡⲁϩⲟ
ⲡⲁϩⲟ]ⲩ	ⲡⲁϩⲟⲩ
ⲡⲁϩⲧ̇	ⲡⲁϩⲧ
ⲡⲁϩⲧ︤	ⲡⲁϩⲧ
ⲡⲁϩ	ⲡⲁϩ
ⲡⲁⲑⲟⲥ	ⲡⲁⲑⲟⲥ
ⲡⲁⲓ̇	ⲡⲁⲓ
ⲡⲁⲓ̈	ⲡⲁⲓ
ⲡⲁⲓⲇⲉⲩⲉ	ⲡⲁⲓⲇⲉⲩⲉ
ⲡⲁⲓ	ⲡⲁⲓ
ⲡⲁⲗⲓⲛ	ⲡⲁⲗⲓⲛ
ⲡⲁⲗⲓⲛ	ⲡⲁⲗⲓⲛ
ⲡⲁⲙⲃⲱ̇	ⲡⲁⲙⲃⲱ
ⲡⲁⲙⲃⲱ	ⲡⲁⲙⲃⲱ
ⲡⲁⲛⲟⲩⲣⲅⲓⲁ	ⲡⲁⲛⲟⲩⲣⲅⲓⲁ
ⲡⲁⲛⲧⲟⲕⲣⲁⲧⲱⲣ⳿	ⲡⲁⲛⲧⲟⲕⲣⲁⲧⲱⲣ
ⲡⲁⲡⲁⲗⲓⲛ	ⲡⲁⲗⲓⲛ
ⲡⲁⲡⲁⲥ	ⲡⲁⲡⲁⲥ
ⲡⲁⲣⲁⲃⲁ⳿	ⲡⲁⲣⲁⲃⲁ
ⲡⲁⲣⲁⲃⲁ	ⲡⲁⲣⲁⲃⲁ
ⲡⲁⲣⲁⲅⲉ	ⲡⲁⲣⲁⲅⲉ
ⲡⲁⲣⲁⲇⲉⲓⲥⲟⲥ	ⲡⲁⲣⲁⲇⲉⲓⲥⲟⲥ
ⲡⲁⲣⲁⲇⲓⲅⲙⲁⲧⲓⲍⲉ⳿	ⲡⲁⲣⲁⲇⲓⲅⲙⲁⲧⲓⲍⲉ
ⲡⲁⲣⲁⲇⲓⲇⲟⲩ	ⲡⲁⲣⲁⲇⲓⲇⲟⲩ
ⲡⲁⲣⲁⲇⲓⲥⲟⲥ`	ⲡⲁⲣⲁⲇⲓⲥⲟⲥ
ⲡⲁⲣⲁⲓⲧⲉⲓ⳿	ⲡⲁⲣⲁⲓⲧⲉⲓ
ⲡⲁⲣⲁⲕⲁⲗⲉⲓ`	ⲡⲁⲣⲁⲕⲁⲗⲉⲓ
ⲡⲁⲣⲁ	ⲡⲁⲣⲁ
ⲡⲁⲣⲃⲁⲥⲓⲥ`	ⲡⲁⲣⲃⲁⲥⲓⲥ
ⲡⲁⲣⲑⲉⲛⲟⲥ	ⲡⲁⲣⲑⲉⲛⲟⲥ
ⲡⲁⲣⲣⲏ̣ⲥⲓⲁ`	ⲡⲁⲣⲣⲏⲥⲓⲁ
ⲡⲁⲣⲣⲏⲥⲓⲁ	ⲡⲁⲣⲣⲏⲥⲓⲁ
ⲡⲁⲣⲣⲏⲥⲓⲁ`	ⲡⲁⲣⲣⲏⲥⲓⲁ
ⲡⲁⲥⲧ	ⲡⲁⲥⲧ
ⲡⲁⲥⲭⲁ⳿	ⲡⲁⲥⲭⲁ
ⲡⲁⲩⲗⲟⲥ	ⲡⲁⲩⲗⲟⲥ
ⲡⲁⲩⲗⲟⲥ`	ⲡⲁⲩⲗⲟⲥ
ⲡⲁ	ⲡⲁ
ⲡⲉ̇	ⲡⲉⲧ
ⲡⲉϥ	ⲡⲉϥ
ⲡⲉϪⲁ	ⲡⲉϫⲁ
ⲡⲉϫⲁ	ⲡⲉϫⲁ
ⲡⲉϫⲉ̇̇	ⲡⲉϫⲉ
ⲡⲉⲑⲟⲟⲩ	ⲡⲉⲑⲟⲟⲩ
ⲡⲉⲓ̇	ⲡⲉⲓ
ⲡⲉⲓ̈	ⲡⲉⲓ
ⲡⲉⲓⲑⲉ⳿	ⲡⲉⲓⲑⲉ
ⲡⲉⲓ	ⲡⲉⲓ
ⲡⲉⲕ	ⲡⲉⲕ
ⲡⲉⲗϭⲉ	ⲡⲉⲗϭⲉ
ⲡⲉⲛ	ⲡⲉⲛ
ⲡⲉⲥ	ⲡⲉⲥ
ⲡⲉⲧⲛ̇	ⲡⲉⲧⲛ
ⲡⲉⲧ︤ⲛ︥	ⲡⲉⲧⲛ
ⲡⲉⲧ	ⲡⲉⲧ
ⲡⲉⲩ	ⲡⲉⲩ
ⲡⲉ⳯	ⲡⲉⲛ
ⲡⲉ⳿	ⲡⲉ
ⲡⲉ⳿	ⲡⲉ
ⲡⲉ⳿	ⲡⲉ
ⲡⲉ	ⲡⲉ
ⲡⲉ	ⲡⲉ
ⲡⲉ	ⲡⲉ
ⲡⲉ`	ⲡⲉ
ⲡⲏϣ	ⲡⲏϣ
ⲡⲏϩ	ⲡⲏϩ
ⲡⲏⲅⲏ̂	ⲡⲏⲅⲏ
ⲡⲏⲟⲩⲉ	ⲡⲏⲩⲉ
ⲡⲏⲧ	ⲡⲏⲧ
ⲡⲏⲧ`	ⲡⲏⲧ
ⲡⲏⲩ̣ⲉ̇	ⲡⲏⲩ̣ⲉ
ⲡⲏⲩⲉ	ⲡⲏⲩⲉ
ⲡⲏⲩⲉ`	ⲡⲏⲩⲉ
ⲡⲓ̇ⲣⲁⲍⲉ	ⲡⲉⲓⲣⲁⲍⲉ
ⲡⲓ̇ⲣⲁⲥⲙⲟⲥ	ⲡⲓⲣⲁⲥⲙⲟⲥ
ⲡⲓ̇ⲥⲧⲉⲩⲉ̇	ⲡⲓⲥⲧⲉⲩⲉ
ⲡⲓ̈	ⲡⲉⲓ
ⲡⲓⲑⲩⲙⲓⲁ	ⲉⲡⲓⲑⲩⲙⲓⲁ
ⲡⲓⲣⲁⲥⲙⲟ̣ⲥ̣	ⲡⲓⲣⲁⲥⲙⲟⲥ
ⲡⲓⲣⲁⲥⲙⲟⲥ	ⲡⲓⲣⲁⲥⲙⲟⲥ
ⲡⲓⲥⲧⲉⲩⲉ	ⲡⲓⲥⲧⲉⲩⲉ
ⲡⲓⲥⲧⲉⲩⲉ`	ⲡⲓⲥⲧⲉⲩⲉ
ⲡⲓⲥⲧⲓⲥ	ⲡⲓⲥⲧⲓⲥ
ⲡⲓⲥⲧⲟⲥ	ⲡⲓⲥⲧⲟⲥ
ⲡⲓ	ⲡⲉⲓ
ⲡⲓ	ⲡⲓ
ⲡⲗⲁⲛⲁ`	ⲡⲗⲁⲛⲁ
ⲡⲗⲁⲥⲥⲉ	ⲡⲗⲁⲥⲥⲉ
ⲡⲗⲏⲅⲉ	ⲡⲗⲏⲅⲉ
ⲡⲗⲏⲅⲏ	ⲡⲗⲏⲅⲏ
ⲡⲗⲏⲛ	ⲡⲗⲏⲛ
ⲡⲛⲏ⳿	ⲡⲛⲏ
ⲡⲛⲟⲩⲧⲉ`	ⲡⲛⲟⲩⲧⲉ
ⲡⲟⲗⲓ̇ⲥ	ⲡⲟⲗⲓⲥ
ⲡⲟⲗⲓⲥ	ⲡⲟⲗⲓⲥ
ⲡⲟⲛⲏⲣⲉⲩⲉ	ⲡⲟⲛⲏⲣⲉⲩⲉ
ⲡⲟⲛⲏⲣⲓⲁ	ⲡⲟⲛⲏⲣⲓⲁ
ⲡⲟⲛⲏⲣⲓⲁ`	ⲡⲟⲛⲏⲣⲓⲁ
ⲡⲟⲛⲏⲣⲟⲛ⳿	ⲡⲟⲛⲏⲣⲟⲛ
ⲡⲟⲛⲏⲣⲟⲛ	ⲡⲟⲛⲏⲣⲟⲛ
ⲡⲟⲛⲏⲣⲟⲛ`	ⲡⲟⲛⲏⲣⲟⲛ
ⲡⲟⲛⲏⲣⲟⲥ⳿	ⲡⲟⲛⲏⲣⲟⲥ
ⲡⲟⲛⲏⲣⲟⲥ	ⲡⲟⲛⲏⲣⲟⲥ
ⲡⲟⲛⲏⲣⲟ⳯	ⲡⲟⲛⲏⲣⲟⲛ
ⲡⲟⲣϣ̣︤	ⲡⲟⲣϣ
ⲡⲟⲣϫ̇	ⲡⲟⲣϫ
ⲡⲟⲣⲛⲉⲓⲁ	ⲡⲟⲣⲛⲉⲓⲁ
ⲡⲟⲣⲛⲓⲁ	ⲡⲟⲣⲛⲓⲁ
ⲡⲟⲩ	ⲡⲟⲩ
ⲡⲣⲁⲝⲓⲥ	ⲡⲣⲁⲝⲓⲥ
ⲡⲣⲉⲥⲃⲩⲧⲉⲣⲟⲥ⳿	ⲡⲣⲉⲥⲃⲩⲧⲉⲣⲟⲥ
ⲡⲣⲉⲥⲃⲩⲧⲉⲣⲟⲥ	ⲡⲣⲉⲥⲃⲩⲧⲉⲣⲟⲥ
ⲡⲣⲏϣ	ⲡⲣⲏϣ
ⲡⲣⲟϩⲓⲥⲧⲁ`	ⲡⲣⲟϩⲓⲥⲧⲁ
ⲡⲣⲟⲇⲟⲧⲏⲥ	ⲡⲣⲟⲇⲟⲧⲏⲥ
ⲡⲣⲟⲥⲫⲟⲣⲁ⳿	ⲡⲣⲟⲥⲫⲟⲣⲁ
ⲡⲣⲟⲫⲏⲧⲏⲥ⳿	ⲡⲣⲟⲫⲏⲧⲏⲥ
ⲡⲣⲟⲫⲏⲧⲏⲥ	ⲡⲣⲟⲫⲏⲧⲏⲥ
ⲡⲣⲟⲫⲏⲧⲏⲥ`	ⲡⲣⲟⲫⲏⲧⲏⲥ
ⲡⲱϩ︤ⲧ︥	ⲡⲱϩⲧ
ⲡⲱϩ︤ⲧ︥`	ⲡⲱϩⲧ
ⲡⲱϩ	ⲡⲱϩ
ⲡⲱⲗⲁϩ	ⲡⲱⲗⲁϩ
ⲡⲱⲛ︤ⲅ︥	ⲡⲱⲛⲅ
ⲡⲱⲣ̇ϫ	ⲡⲱⲣϫ
ⲡⲱⲣ︤ϫ︥	ⲡⲱⲣϫ
ⲡⲱⲧ⳿	ⲡⲱⲧ
ⲡⲱⲧ	ⲡⲱⲧ
ⲡⲱⲧ`	ⲡⲱⲧ
ⲡⲱⲱⲛⲉ	ⲡⲱⲱⲛⲉ
ⲡⲱ	ⲡⲱ
ⲡ︤ⲛ︦ⲁ︥	ⲡⲛⲉⲩⲙⲁ
ⲡ︤	ⲡ
ⲡ︥ⲟⲛⲏⲣⲟⲥ	ⲡⲟⲛⲏⲣⲟⲥ
ⲡ︥	ⲡ
ⲡ	ⲡ
ⲡ	ⲡ
ⲡ 	ⲡ
ⲡ]	ⲡ
Ⲣⲱⲙⲉ	ⲣⲱⲙⲉ
ⲣ̂ϣⲁⲩ	ⲣϣⲁⲩ
ⲣ̂ϣⲁ⳿	ⲣϣⲁ
ⲣ̂ϩⲏⲃⲉ⳿	ⲣϩⲏⲃⲉ
ⲣ̂ϩⲟⲧⲉ	ⲣϩⲟⲧⲉ
ⲣ̂ϩⲱⲃ	ⲣϩⲱⲃ
ⲣ̂ϩ︤ⲙ︥ϩⲁⲗ	ⲣϩⲙϩⲁⲗ
ⲣ̂ϫⲟⲉⲓⲥ	ⲣϫⲟⲉⲓⲥ
ⲣ̂ⲕⲃⲁ̂	ⲣⲕⲃⲁ
ⲣ̂ⲕⲃⲁ⳿	ⲣⲕⲃⲁ
ⲣ̂ⲙⲛ︤ⲧ︥ⲣⲉ⳿	ⲣⲙⲛⲧⲣⲉ
ⲣ̂ⲛⲟϭ	ⲣⲛⲟϭ
ⲣ̂ⲛⲟⲃⲉ	ⲣⲛⲟⲃⲉ
ⲣ̂ⲟⲩⲟⲉⲓⲛ	ⲣⲟⲩⲟⲉⲓⲛ
ⲣ̂ⲧⲁⲃ⳿	ⲣⲧⲁⲃ
ⲣ̂	ⲣ
ⲣ̄ϣ̣[ⲁⲩ	ⲣϣⲁⲩ
ⲣ̄ϣⲁⲩ	ⲣϣⲁⲩ
ⲣ̄ϩⲁϩ	ⲣϩⲁϩ
ⲣ̄ϩⲟⲧⲉ	ⲣϩⲟⲧⲉ
ⲣ̄ϩⲟⲩⲟ	ⲣϩⲟⲩⲟ
ⲣ̄ϩⲟⲩⲟ`	ⲣϩⲟⲩⲟ
ⲣ̄ϩⲱⲃ	ⲣϩⲱⲃ
ⲣ̄ϩⲱⲃ	ⲣϩⲱⲃ
ⲣ̄ⲕⲁⲕⲉ	ⲣⲕⲁⲕⲉ
ⲣ̄ⲙⲏ̂	ⲣⲙⲏ
ⲣ̄ⲛⲁⲃⲉ	ⲣⲛⲟⲃⲉ
ⲣ̄ⲛⲟⲃⲉ	ⲣⲛⲟⲃⲉ
ⲣ̄ⲛⲟⲃⲉ`	ⲣⲛⲟⲃⲉ
ⲣ̄ⲟⲩⲟⲉⲓⲛ	ⲣⲟⲩⲟⲉⲓⲛ
ⲣ̄ⲡⲉ	ⲣⲡⲉ
ⲣ̄ⲣ̄ϩⲟⲧⲉ	ⲣϩⲟⲧⲉ
ⲣ̄ⲣⲟ	ⲣⲣⲟ
ⲣ̄ⲥⲟϭ	ⲣⲥⲟϭ
ⲣ̄ⲭⲣⲉⲓⲁ	ⲣⲭⲣⲉⲓⲁ
ⲣ̄ⲭⲣⲓⲁ	ⲣⲭⲣⲉⲓⲁ
ⲣ̄	ⲣ
ⲣ̇ϣ̇ⲡⲏⲣⲉ	ⲣϣⲡⲏⲣⲉ
ⲣ̇ϩ̇ⲟⲧⲉ	ⲣϩⲟⲧⲉ
ⲣ̇ϩⲟⲧⲉ	ⲣϩⲟⲧⲉ
ⲣ̇ⲙⲟⲛⲁⲭⲟⲥ	ⲣⲙⲟⲛⲁⲭⲟⲥ
ⲣ̇ⲛⲟⲃⲣⲉ	ⲣⲛⲟⲃⲣⲉ
ⲣ̇ⲣ̇ⲟ	ⲣⲣⲟ
ⲣ̇	ⲣ
ⲣ̇	ⲣ
ⲣ̣̂ⲛ̣ⲟⲃⲉ	ⲣⲛⲟⲃⲉ
ⲣ̣ⲱⲙⲉ	ⲣⲱⲙⲉ
ⲣϣⲁⲩ	ⲣϣⲁⲩ
ⲣϩ︤ⲙ︥ⲙⲉ	ⲣϩⲙⲙⲉ
ⲣϩ︤ⲙ︥ⲙⲉ	ⲣϩⲙⲙⲉ
ⲣϩ[ⲛⲁ]ⲩ	ⲣϩⲛⲁⲩ
ⲣⲁϣⲉ	ⲣⲁϣⲉ
ⲣⲁⲕⲟⲧⲉ	ⲣⲁⲕⲟⲧⲉ
ⲣⲁⲛ⳿	ⲣⲁⲛ
ⲣⲁⲛ	ⲣⲁⲛ
ⲣⲁⲛ`	ⲣⲁⲛ
ⲣⲁⲥⲟⲩ	ⲣⲁⲥⲟⲩ
ⲣⲁⲥⲟⲩ`	ⲣⲁⲥⲟⲩ
ⲣⲁⲧ︤	ⲣⲁⲧ
ⲣⲁⲧ	ⲣⲁⲧ
ⲣⲉϥϣⲉⲡϩⲓ̇ⲥⲉ	ⲣⲉϥϣⲡϩⲓⲥⲉ
ⲣⲉϥϣ︤ⲙ︥ϣⲉⲉⲓⲇⲱⲗⲟⲛ⳿	ⲣⲉϥϣⲙϣⲉⲉⲓⲇⲱⲗⲟⲛ
ⲣⲉϥϩⲱⲧ︤ⲃ︥	ⲣⲉϥϩⲱⲧⲃ
ⲣⲉϥϫⲓϣⲟϫⲛⲉ	ⲣⲉϥϫⲓϣⲟϫⲛⲉ
ⲣⲉϥϫⲓⲛϭⲟⲛ︤ⲥ︥	ⲣⲉϥϫⲓⲛϭⲟⲛⲥ
ⲣⲉϥϫⲓⲟⲩⲉ	ⲣⲉϥϫⲓⲟⲩⲉ
ⲣⲉϥϫⲓⲟⲩⲉ`	ⲣⲉϥϫⲓⲟⲩⲉ
ⲣⲉϥϫⲓ	ⲣⲉϥϫⲓ
ⲣⲉϥϯϩⲁⲡ	ⲣⲉϥϯϩⲁⲡ
ⲣⲉϥϯ	ⲣⲉϥϯ
ⲣⲉϥⲙⲟⲟⲩⲧ	ⲣⲉϥⲙⲟⲟⲩⲧ
ⲣⲉϥⲛ̄ⲕⲟⲧ︤ⲕ︥	ⲣⲉϥⲛⲕⲟⲧⲕ
ⲣⲉϥⲣ̄ⲛⲟⲃⲉ	ⲣⲉϥⲣⲛⲟⲃⲉ
ⲣⲉϥⲣ̄	ⲣⲉϥⲣ
ⲣⲉϥⲣⲛⲟⲃⲉ	ⲣⲉϥⲣⲛⲟⲃⲉ
ⲣⲏⲧ⳿	ⲣⲏⲧ
ⲣⲏ⳿	ⲣⲏ
ⲣⲓ̇ⲙⲉ	ⲣⲓⲙⲉ
ⲣⲓ̇	ⲣⲓ
ⲣⲓⲙⲉ	ⲣⲓⲙⲉ
ⲣⲓⲙⲉ	ⲣⲓⲙⲉ
ⲣⲓⲣ⳿	ⲣⲓⲣ
ⲣⲙ̣ⲉⲓⲟⲟⲩⲉ	ⲣⲙⲉⲓⲟⲟⲩⲉ
ⲣⲙⲛⲕⲁϩ	ⲣⲙⲛⲕⲁϩ
ⲣⲛⲟⲃⲉ	ⲣⲛⲟⲃⲉ
ⲣⲟ̂	ⲣⲟ
ⲣⲟⲉⲓ̈ⲥ	ⲣⲟⲉⲓⲥ
ⲣⲟⲉⲓⲥ⳿	ⲣⲟⲉⲓⲥ
ⲣⲟⲉⲓⲥ⳿	ⲣⲟⲉⲓⲥ
ⲣⲟⲙⲡⲉ	ⲣⲟⲙⲡⲉ
ⲣⲟⲟⲩϣ	ⲣⲟⲟⲩϣ
ⲣⲟⲟⲩϣ`	ⲣⲟⲟⲩϣ
ⲣⲟⲩⲟ[ⲉⲓ]ⲛ̣	ⲣⲟⲩⲟⲉⲓⲛ
ⲣⲟ	ⲣⲟ
ⲣⲟ	ⲣⲟ
ⲣⲡⲉ	ⲣⲡⲉ
ⲣⲣⲱⲟⲩ	ⲣⲣⲱⲟⲩ
ⲣⲱ̂	ⲣⲱ
ⲣⲱ̂	ⲣⲱ
ⲣⲱϣⲉ	ⲣⲱϣⲉ
ⲣⲱϣⲉ	ⲣⲱϣⲉ
ⲣⲱϩ︤ⲧ︥	ⲣⲱϩⲧ
ⲣⲱⲘⲉ	ⲣⲱⲙⲉ
ⲣⲱⲙⲉ	ⲣⲱⲙⲉ
ⲣⲱⲙⲉ`	ⲣⲱⲙⲉ
ⲣⲱⲟⲩ	ⲣⲱⲟⲩ
ⲣⲱⲧ	ⲣⲱⲧ
ⲣⲱⲧ`	ⲣⲱⲧ
ⲣⲱ⳿	ⲣⲱ
ⲣⲱ	ⲣⲱ
ⲣ⳿ϭⲣⲱϩ⳿	ⲣϭⲣⲱϩ
ⲣ⳿ⲛⲟϭ	ⲣⲛⲟϭ
ⲣ⳿ⲣⲱⲟⲩ	ⲣⲣⲱⲟⲩ
ⲣ⳿ⲥⲧ	ⲣⲥⲧ
ⲣ︤ⲙ︥ⲛ̄ϩⲏⲧ	ⲣⲙⲛϩⲏⲧ
ⲣ︤ⲙ︥ⲛ̄	ⲣⲙⲛ
ⲣ︤ⲙ︦ⲛ︥	ⲣⲙⲛ
ⲣ︥ⲣⲟ`	ⲣⲣⲟ
ⲣ︥	ⲣ
ⲣ	ⲣ
ⲣ`	ⲣ
Ⲥⲉ	ⲥⲉ
Ⲥⲟⲟⲩⲛ	ⲥⲟⲟⲩⲛ
ⲥ̇ϭⲣⲁϩⲧ̇	ⲥϭⲣⲁϩⲧ
ⲥ̇ⲛⲁⲩ	ⲥⲛⲁⲩ
ⲥ̇ⲭⲩⲙⲁ	ⲥⲭⲏⲙⲁ
ⲥ̇	ⲥ
ⲥ̣ⲁ̣ⲃ̣ⲉ̣	ⲥⲁⲃⲉ
ⲥ̣ⲟ̣ⲛ	ⲥⲟⲛ
ⲥ̣ⲣ̣	ⲥⲣ
ⲥ̣ⲱⲧ[ⲙ	ⲥⲱⲧⲙ
ⲥ̣	ⲥ
ⲥ̣	ⲥ
ⲥϩⲓⲙⲉ	ⲥϩⲓⲙⲉ
ⲥϩⲓⲙⲉ`	ⲥϩⲓⲙⲉ
ⲥϩⲟⲩⲟⲢⲧ`	ⲥϩⲟⲩⲟⲣⲧ
ⲥϩⲟⲩⲟⲣⲧ	ⲥϩⲟⲩⲟⲣⲧ
ⲥϩⲟⲩⲟⲣ︤ⲧ︥	ⲥϩⲟⲩⲟⲣⲧ
ⲥϩⲟⲩⲟⲣ︤ⲧ︥`	ⲥϩⲟⲩⲟⲣⲧ
ⲥϩⲟⲩⲣ̄	ⲥϩⲟⲩⲣ
ⲥϩⲟⲩⲱ̣ⲣ	ⲥϩⲟⲩⲱⲣ
ⲥϩ[ⲟⲩⲟⲣⲧ]	ⲥϩⲟⲩⲟⲣⲧ
ⲥϭⲏⲣ⳿	ⲥϭⲏⲣ
ⲥⲁϣⲉ	ⲥⲁϣⲉ
ⲥⲁϣ︤ϥ︥	ⲥⲁϣϥ
ⲥⲁϩ̣	ⲥⲁϩ
ⲥⲁϩⲛⲉ	ⲥⲁϩⲛⲉ
ⲥⲁϩⲛⲉ`	ⲥⲁϩⲛⲉ
ⲥⲁϩⲟⲩ	ⲥⲁϩⲟⲩ
ⲥⲁϩⲟⲩ	ⲥⲁϩⲟⲩ
ⲥⲁϩⲟⲩ`	ⲥⲁϩⲟⲩ
ⲥⲁϩⲟ[ⲩ	ⲥⲁϩⲟⲩ
ⲥⲁϩⲱ	ⲥⲁϩⲱ
ⲥⲁϩ︤ⲛ︥ⲉ	ⲥⲁϩⲛⲉ
ⲥⲁϩ	ⲥⲁϩ
ⲥⲁϩ`	ⲥⲁϩ
ⲥⲁⲃⲉ	ⲥⲁⲃⲉ
ⲥⲁⲉⲓ̈ⲛ	ⲥⲁⲉⲓⲛ
ⲥⲁⲗⲡⲓⲅ︤ⲝ︥	ⲥⲁⲗⲡⲓⲅⲝ
ⲥⲁⲗⲡⲓⲍⲉ	ⲥⲁⲗⲡⲓⲍⲉ
ⲥⲁⲙⲯⲱⲛ`	ⲥⲁⲙⲯⲱⲛ
ⲥⲁⲛⲟⲩϣ	ⲥⲁⲛⲟⲩϣ
ⲥⲁⲛ︤ϣ︥	ⲥⲁⲛϣ
ⲥⲁⲣⲁⲡⲓ̇ⲟⲛ	ⲥⲁⲣⲁⲡⲓⲟⲛ
ⲥⲁⲣⲕⲓⲕⲟⲛ	ⲥⲁⲣⲕⲓⲕⲟⲛ
ⲥⲁⲣⲝ̇	ⲥⲁⲣⲝ
ⲥⲁⲣⲝ	ⲥⲁⲣⲝ
ⲥⲁⲣⲣⲁ	ⲥⲁⲣⲣⲁ
ⲥⲁⲣⲣⲁ`	ⲥⲁⲣⲣⲁ
ⲥⲁⲣ︤ⲝ︥	ⲥⲁⲣⲝ
ⲥⲁⲣ︤ⲝ︥`	ⲥⲁⲣⲝ
ⲥⲁⲧⲁⲛⲁⲥ⳿	ⲥⲁⲧⲁⲛⲁⲥ
ⲥⲁⲧⲁⲛⲁⲥ	ⲥⲁⲧⲁⲛⲁⲥ
ⲥⲁⲧⲁⲛⲁⲥ`	ⲥⲁⲧⲁⲛⲁⲥ
ⲥⲁⲧⲁ[ⲛ]ⲁⲥ	ⲥⲁⲧⲁⲛⲁⲥ
ⲥⲁⲧⲉ`	ⲥⲁⲧⲉ
ⲥⲁ	ⲥⲁ
ⲥⲁ	ⲥⲁ
ⲥⲃⲟⲟⲩⲉ	ⲥⲃⲟⲟⲩⲉ
ⲥⲃⲟ	ⲥⲃⲟ
ⲥⲃⲱ̂	ⲥⲃⲱ
ⲥⲃⲱ	ⲥⲃⲱ
ⲥⲉⲉ̇ⲡⲉ	ⲥⲉⲉⲡⲉ
ⲥⲉⲓ	ⲥⲉⲓ
ⲥⲉⲗⲓⲥ⳿	ⲥⲉⲗⲓⲥ
ⲥⲉⲛⲟⲩⲑⲓⲟⲩ	ⲥⲉⲛⲟⲩⲑⲓⲟⲩ
ⲥⲉⲧ︤ⲡ︥	ⲥⲉⲧⲡ
ⲥⲉⲩϩ⳿	ⲥⲉⲩϩ
ⲥⲉ⳿	ⲥⲉ
ⲥⲉ	ⲥⲉ
ⲥⲉ	ⲥⲉ
ⲥⲉ	ⲥⲉ
ⲥⲉ	ⲥⲉ
ⲥⲏϣ	ⲥⲏϣ
ⲥⲏϥⲉ	ⲥⲏϥⲉ
ⲥⲏϩ⳿	ⲥⲏϩ
ⲥⲏϩ	ⲥⲏϩ
ⲥⲏϩ`	ⲥⲏϩ
ⲥⲓϣⲉ	ⲥⲓϣⲉ
ⲥⲓⲟⲟⲩⲛⲉ⳿	ⲥⲓⲟⲟⲩⲛⲉ
ⲥⲓⲟⲩⲣ	ⲥⲓⲟⲩⲣ
ⲥⲓⲟⲩⲣ`	ⲥⲓⲟⲩⲣ
ⲥⲓⲟⲩ	ⲥⲓⲟⲩ
ⲥⲓ[....]ⲟⲩ	ⲥⲓ[....]ⲟⲩ
ⲥⲕⲁⲛⲇⲁⲗⲓⲍⲉ	ⲥⲕⲁⲛⲇⲁⲗⲓⲍⲉ
ⲥⲕⲁⲛⲇⲁⲗⲟⲛ	ⲥⲕⲁⲛⲇⲁⲗⲟⲛ
ⲥⲕⲉⲡⲁⲥⲧⲏⲥ	ⲥⲕⲉⲡⲁⲥⲧⲏⲥ
ⲥⲗⲁⲁⲧⲉ	ⲥⲗⲁⲁⲧⲉ
ⲥⲙ̣ⲁⲧⲁ̣ⲁ̣ⲁ̣	ⲥⲙⲁⲧⲁⲁⲁ
ⲥⲙⲁⲙⲁⲁⲧ⳿	ⲥⲙⲁⲙⲁⲁⲧ
ⲥⲙⲁⲙⲁⲁⲧ	ⲥⲙⲁⲙⲁⲁⲧ
ⲥⲙⲓⲛⲉ	ⲥⲙⲓⲛⲉ
ⲥⲙⲓ︤ⲛ︥ⲉ`	ⲥⲙⲓⲛⲉ
ⲥⲙⲟⲧ	ⲥⲙⲟⲧ
ⲥⲙⲟⲧ`	ⲥⲙⲟⲧ
ⲥⲙⲟⲩ̣`	ⲥⲙⲟⲩ
ⲥⲙⲟⲩ	ⲥⲙⲟⲩ
ⲥⲙⲟⲩ	ⲥⲙⲟⲩ
ⲥⲙⲟⲩ`	ⲥⲙⲟⲩ
ⲥⲛⲁⲩ	ⲥⲛⲁⲩ
ⲥⲛⲁⲩ`	ⲥⲛⲁⲩ
ⲥⲛⲏⲩ̣	ⲥⲛⲏⲩ
ⲥⲛⲏⲩ⳿	ⲥⲛⲏⲩ
ⲥⲛⲏⲩ	ⲥⲛⲏⲩ
ⲥⲛⲏⲩ`	ⲥⲛⲏⲩ
ⲥⲛⲟϥ	ⲥⲛⲟϥ
ⲥⲛⲟⲟϥ	ⲥⲛⲟⲟϥ
ⲥⲛⲧⲉ	ⲥⲛⲧⲉ
ⲥⲟ̂	ⲥⲟ
ⲥⲟ̇ⲟ	ⲥⲟⲟ
ⲥⲟϣϥ	ⲥⲟϣϥ
ⲥⲟϭ	ⲥⲟϭ
ⲥⲟⲃⲧⲉ	ⲥⲟⲃⲧⲉ
ⲥⲟⲃⲧⲉ	ⲥⲟⲃⲧⲉ
ⲥⲟⲃ︤ⲧ︥	ⲥⲟⲃⲧ
ⲥⲟⲉⲓⲧ`	ⲥⲟⲉⲓⲧ
ⲥⲟⲗⲟⲙⲱⲛ	ⲥⲟⲗⲟⲙⲱⲛ
ⲥⲟⲛ̇	ⲥⲟⲛ
ⲥⲟⲛ	ⲥⲟⲛ
ⲥⲟⲛ`	ⲥⲟⲛ
ⲥⲟⲟ̇ⲩⲛ̇	ⲥⲟⲟⲩⲛ
ⲥⲟⲟϥ	ⲥⲟⲟϥ
ⲥⲟⲟϩⲉ`	ⲥⲟⲟϩⲉ
ⲥⲟⲟⲩϩ	ⲥⲟⲟⲩϩ
ⲥⲟⲟⲩⲛ⳿	ⲥⲟⲟⲩⲛ
ⲥⲟⲟⲩⲛ	ⲥⲟⲟⲩⲛ
ⲥⲟⲟⲩⲛ	ⲥⲟⲟⲩⲛ
ⲥⲟⲟⲩⲛ`	ⲥⲟⲟⲩⲛ
ⲥⲟⲟⲩⲧⲛ̄	ⲥⲟⲟⲩⲧⲛ
ⲥⲟⲟⲩⲧ︤ⲛ︥	ⲥⲟⲟⲩⲧⲛ
ⲥⲟⲟⲩⲧ︤ⲛ︥	ⲥⲟⲟⲩⲧⲛ
ⲥⲟⲟⲩ⳯	ⲥⲟⲟⲩⲛ
ⲥⲟⲟⲩ⳯ ⳿	ⲥⲟⲟⲩⲛ
ⲥⲟⲟⲩ	ⲥⲟⲟⲩ
ⲥⲟⲡ̣ⲥ	ⲥⲟⲡⲥ
ⲥⲟⲡⲥ̄	ⲥⲟⲡⲥ
ⲥⲟⲡ︤ⲥ︥	ⲥⲟⲡⲥ
ⲥⲟⲡ	ⲥⲟⲡ
ⲥⲟⲡ[.]	ⲥⲟⲡ[.]
ⲥⲟⲡ`	ⲥⲟⲡ
ⲥⲟⲣⲙⲉ	ⲥⲟⲣⲙⲉ
ⲥⲟⲣⲙ	ⲥⲟⲣⲙ
ⲥⲟⲣ︤	ⲥⲟⲣ
ⲥⲟⲣ]ⲙ	ⲥⲟⲣⲙ
ⲥⲟⲧⲙ	ⲥⲟⲧⲙ
ⲥⲟⲧⲡ︤	ⲥⲟⲧⲡ
ⲥⲟⲧⲡ︤	ⲥⲟⲧⲡ
ⲥⲟⲧ︤ⲡ︥	ⲥⲟⲧⲡ
ⲥⲟⲧ︤ⲡ︥`	ⲥⲟⲧⲡ
ⲥⲟⲩⲉ̇ⲛ	ⲥⲟⲩⲉⲛ
ⲥⲟⲩⲛ̇ⲧ	ⲥⲟⲩⲛⲧ
ⲥⲟⲩⲛ	ⲥⲟⲩⲛ
ⲥⲟⲩⲟ̂	ⲥⲟⲩⲟ
ⲥⲟⲩⲱ̂ⲛ︤	ⲥⲟⲩⲱⲛ
ⲥⲟⲩⲱ̇ⲛ	ⲥⲟⲩⲱⲛ
ⲥⲟⲩⲱⲛ︤	ⲥⲟⲩⲱⲛ
ⲥⲟⲩⲱⲛ	ⲥⲟⲩⲱⲛ
ⲥⲟⲩ	ⲥⲟⲩ
ⲥⲟⲫⲟⲥ	ⲥⲟⲫⲟⲥ
ⲥⲟ⳿	ⲥⲟ
ⲥⲟ`	ⲥⲟ
ⲥⲡⲉⲣⲙⲁ`	ⲥⲡⲉⲣⲙⲁ
ⲥⲡⲟⲧⲟⲩ	ⲥⲡⲟⲧⲟⲩ
ⲥⲡⲟⲩⲇⲁⲍⲉ	ⲥⲡⲟⲩⲇⲁⲍⲉ
ⲥⲡⲟⲩⲇⲏ	ⲥⲡⲟⲩⲇⲏ
ⲥⲣⲁϩ︤ⲧ︥	ⲥⲣⲁϩⲧ
ⲥⲣ︤ⲙ︥ⲣⲱⲙ	ⲥⲣⲙⲣⲱⲙ
ⲥⲣ	ⲥⲣ
ⲥⲧⲉⲣⲉⲱⲙⲁ	ⲥⲧⲉⲣⲉⲱⲙⲁ
ⲥⲩⲙⲃⲟⲩⲗⲉⲩⲉ`	ⲥⲩⲙⲃⲟⲩⲗⲉⲩⲉ
ⲥⲩⲛϩⲉⲇⲣⲓⲟⲛ	ⲥⲩⲛϩⲉⲇⲣⲓⲟⲛ
ⲥⲩⲛⲁⲅⲟⲅⲏ`	ⲥⲩⲛⲁⲅⲱⲅⲏ
ⲥⲩⲛⲁⲅⲱⲅⲏ	ⲥⲩⲛⲁⲅⲱⲅⲏ
ⲥⲩⲛⲁⲅⲱⲅⲏ`	ⲥⲩⲛⲁⲅⲱⲅⲏ
ⲥⲩⲛⲕ̇ⲗⲏⲧⲓ̇ⲕⲏ	ⲥⲩⲛⲕⲗⲏⲧⲓⲕⲏ
ⲥⲩⲛⲕ̇ⲗⲏⲧⲓ̇ⲕⲟⲥ	ⲥⲩⲛⲕⲗⲏⲧⲓⲕⲟⲥ
ⲥⲩⲛⲧⲉⲗⲉⲓⲁ	ⲥⲩⲛⲧⲉⲗⲉⲓⲁ
ⲥⲩⲛⲧⲉⲗⲓⲁ`	ⲥⲩⲛⲧⲉⲗⲓⲁ
ⲥⲩⲛ	ⲥⲩⲛ
ⲥⲩⲣⲁ`	ⲥⲩⲣⲁ
ⲥⲩⲣⲉ	ⲥⲩⲣⲉ
ⲥⲱ̇	ⲥⲱ
ⲥⲱϣⲉ	ⲥⲱϣⲉ
ⲥⲱϣⲉ`	ⲥⲱϣⲉ
ⲥⲱϣ︤ϥ︥	ⲥⲱϣϥ
ⲥⲱϣ	ⲥⲱϣ
ⲥⲱϣ	ⲥⲱϣ
ⲥⲱⲃⲉ	ⲥⲱⲃⲉ
ⲥⲱⲕ	ⲥⲱⲕ
ⲥⲱⲙⲁ	ⲥⲱⲙⲁ
ⲥⲱⲙⲁ`	ⲥⲱⲙⲁ
ⲥⲱⲛⲉ	ⲥⲱⲛⲉ
ⲥⲱⲛⲉ`	ⲥⲱⲛⲉ
ⲥⲱⲛ︤ⲧ︥	ⲥⲱⲛⲧ
ⲥⲱⲛ︤ⲧ︥	ⲥⲱⲛⲧ
ⲥⲱⲟⲩϩ̇	ⲥⲱⲟⲩϩ
ⲥⲱⲟⲩϩ	ⲥⲱⲟⲩϩ
ⲥⲱⲟⲩ	ⲥⲱⲟⲩ
ⲥⲱⲣ︤ⲙ︥	ⲥⲱⲣⲙ
ⲥⲱⲧⲉ⳿	ⲥⲱⲧⲉ
ⲥⲱⲧⲉ`	ⲥⲱⲧⲉ
ⲥⲱⲧⲏⲣⲓⲁ	ⲥⲱⲧⲏⲣⲓⲁ
ⲥⲱⲧⲏⲣ	ⲥⲱⲧⲏⲣ
ⲥⲱⲧⲙ̇	ⲥⲱⲧⲙ
ⲥⲱⲧⲙ	ⲥⲱⲧⲙ
ⲥⲱⲧⲡ⳯	ⲥⲱⲧⲡ
ⲥⲱⲧ︤ⲙ︥	ⲥⲱⲧⲙ
ⲥⲱⲧ`	ⲥⲱⲧ
ⲥⲱⲱϥ⳿	ⲥⲱⲱϥ
ⲥⲱⲱϥ	ⲥⲱⲱϥ
ⲥⲱⲱϥ	ⲥⲱⲱϥ
ⲥⲱ⳯	ⲥⲱⲛ
ⲥⲱ	ⲥⲱ
ⲥⳁⲟⲥ	ⲥⲧⲁⲩⲣⲟⲥ
ⲥⳁⲟⲥ`	ⲥⲧⲁⲩⲣⲟⲥ
ⲥ⳿ϩⲟⲩⲟⲣ︤ⲧ︥	ⲥϩⲟⲩⲟⲣⲧ
ⲥ⳿	ⲥ
ⲥ⳿	ⲥ
ⲥ︤ϩ︥ⲟⲩⲟⲣ︤ⲧ︥	ⲥϩⲟⲩⲟⲣⲧ
ⲥ︤ⲃ︥ⲧⲱⲧ	ⲥⲃⲧⲱⲧ
ⲥ︤ⲙ︥ⲙⲉ	ⲥⲙⲙⲉ
ⲥ︤ⲙ︥	ⲥⲙ
ⲥ︤ⲛ︥ⲧⲉ`	ⲥⲛⲧⲉ
ⲥ︤ⲣ︥ϥⲉ⳿	ⲥⲣϥⲉ
ⲥ︤ⲣ︥ϥⲉ	ⲥⲣϥⲉ
ⲥ︥	ⲥ
ⲥ︥	ⲥ
ⲥ	ⲥ
ⲥ	ⲥ
ⲥ	ⲥ
ⲥ]ⲉ̣	ⲥⲉ
ⲥ`	ⲥ
ⲥ`	ⲥ
Ⲧⲁⲓ̈	ⲧⲁⲓ
Ⲧⲉ	ⲧⲉ
Ⲧⲟⲧⲉ	ⲧⲟⲧⲉ
Ⲧⲱⲙ̂	ⲧⲱⲙ
ⲧ̄[	ⲧ
ⲧ̇ⲙⲏ	ⲧⲙⲏ
ⲧ̇ⲣⲉ	ⲧⲣⲉ
ⲧ̇ⲣ	ⲧⲣ
ⲧ̇	ⲧ
ⲧ̇	ⲧ
ⲧ̣ⲙ̣	ⲧⲙ
ⲧ̣ⲟ̣ⲡⲟⲥ	ⲧⲟⲡⲟⲥ
ⲧ̣ⲟⲟⲧ	ⲧⲟⲟⲧ
ⲧ̣︤ⲛ̣̄	ⲧⲛ
ⲧ̣	ⲧ
ⲧϩⲛⲉⲣⲱⲙⲉ	ⲧϩⲛⲉⲣⲱⲙⲉ
ⲧϭⲁⲓ̈ⲉ	ⲧϭⲁⲓⲉ
ⲧϭⲁⲓ̈ⲏⲩ`	ⲧϭⲁⲓⲏⲩ
ⲧϭⲁⲓⲏⲩ	ⲧϭⲁⲓⲏⲩ
ⲧⲁ̇ⲁ	ⲧⲁⲁ
ⲧⲁϣⲉ	ⲧⲁϣⲉ
ⲧⲁϩⲉ	ⲧⲁϩⲉ
ⲧⲁϩⲙ	ⲧⲁϩⲙ
ⲧⲁϩⲟ	ⲧⲁϩⲟ
ⲧⲁϩ︤ⲙ︥	ⲧⲁϩⲙ
ⲧⲁϩ︤ⲥ︥	ⲧⲁϩⲥ
ⲧⲁϫⲣⲏⲩ	ⲧⲁϫⲣⲏⲩ
ⲧⲁϫⲣⲟ̂	ⲧⲁϫⲣⲟ
ⲧⲁϫⲣⲟ	ⲧⲁϫⲣⲟ
ⲧⲁϭⲥⲉ	ⲧⲁϭⲥⲉ
ⲧⲁⲁ	ⲧⲁⲁ
ⲧⲁⲉ̣[ⲓⲏⲩ	ⲧⲁⲉⲓⲏⲩ
ⲧⲁⲉⲓ̇ⲏⲩ	ⲧⲁⲉⲓⲏⲩ
ⲧⲁⲉⲓⲏⲩ	ⲧⲁⲉⲓⲏⲩ
ⲧⲁⲉⲓⲟ̂	ⲧⲁⲉⲓⲟ
ⲧⲁⲓ̇ⲟ	ⲧⲁⲓⲟ
ⲧⲁⲓ̇	ⲧⲁⲓ
ⲧⲁⲓ̈ⲉ⳿	ⲧⲁⲓⲉ
ⲧⲁⲓ̈ⲏⲩ	ⲧⲁⲉⲓⲏⲩ
ⲧⲁⲓ̈ⲟ̂	ⲧⲁⲓⲟ
ⲧⲁⲓ̈	ⲧⲁⲓ
ⲧⲁⲓ	ⲧⲁⲓ
ⲧⲁⲕⲉ	ⲧⲁⲕⲉ
ⲧⲁⲕⲟ̂	ⲧⲁⲕⲟ
ⲧⲁⲕⲟ	ⲧⲁⲕⲟ
ⲧⲁⲕⲟ	ⲧⲁⲕⲟ
ⲧⲁⲗϭⲟ	ⲧⲁⲗϭⲟ
ⲧⲁⲙⲉ	ⲧⲁⲙⲉ
ⲧⲁⲙⲓⲟⲛ	ⲧⲁⲙⲉⲓⲟⲛ
ⲧⲁⲙⲓⲉ	ⲧⲁⲙⲓⲉ
ⲧⲁⲙⲓⲟ	ⲧⲁⲙⲓⲟ
ⲧⲁⲙⲓⲟ`	ⲧⲁⲙⲓⲟ
ⲧⲁⲙⲓⲱ	ⲧⲁⲙⲓⲱ
ⲧⲁⲙⲟ̂	ⲧⲁⲙⲟ
ⲧⲁⲙⲟⲓ̈	ⲧⲁⲙⲟⲓ
ⲧⲁⲙⲟ	ⲧⲁⲙⲟ
ⲧⲁⲙⲟ	ⲧⲁⲙⲟ
ⲧⲁⲙⲟ	ⲧⲁⲙⲟ
ⲧⲁⲙⲱ	ⲧⲁⲙⲱ
ⲧⲁⲟⲩⲉ	ⲧⲁⲟⲩⲉ
ⲧⲁⲡⲣⲟ̂	ⲧⲁⲡⲣⲟ
ⲧⲁⲡⲣⲟ	ⲧⲁⲡⲣⲟ
ⲧⲁⲣⲉ	ⲧⲁⲣⲉ
ⲧⲁⲣ︤	ⲧⲁⲣ
ⲧⲁⲣ	ⲧⲁⲣ
ⲧⲁⲩⲉ⳿	ⲧⲁⲩⲉ
ⲧⲁⲩⲟ̂	ⲧⲁⲩⲟ
ⲧⲁⲩⲟⲩⲟ	ⲧⲁⲩⲟⲩⲟ
ⲧⲁ	ⲧⲁ
ⲧⲁ	ⲁ
ⲧⲁ	ⲧⲁ
ⲧⲁ	ⲧⲁ
ⲧⲃⲃⲏⲩ	ⲧⲃⲃⲏⲩ
ⲧⲃⲃⲟ	ⲧⲃⲃⲟ
ⲧⲉϥ̣	ⲧⲉϥ
ⲧⲉϥ	ⲧⲉϥ
ⲧⲉϩ︤ⲥ︥	ⲧⲉϩⲥ
ⲧⲉⲓ̇	ⲧⲉⲓ
ⲧⲉⲓ̈	ⲧⲉⲓ
ⲧⲉⲓ	ⲧⲉⲓ
ⲧⲉⲕ	ⲧⲉⲕ
ⲧⲉⲗⲱⲛⲏⲥ	ⲧⲉⲗⲱⲛⲏⲥ
ⲧⲉⲗⲱⲛⲏⲥ`	ⲧⲉⲗⲱⲛⲏⲥ
ⲧⲉⲚⲟⲩ	ⲧⲉⲛⲟⲩ
ⲧⲉⲛ̣[ⲟⲩ]	ⲧⲉⲛⲟⲩ
ⲧⲉⲛⲟⲩ	ⲧⲉⲛⲟⲩ
ⲧⲉⲛⲟⲩ`	ⲧⲉⲛⲟⲩ
ⲧⲉⲛ	ⲧⲉⲛ
ⲧⲉⲛ[ⲟⲩ]	ⲧⲉⲛⲟⲩ
ⲧⲉⲥⲙ︤ⲛ︦ⲧ︥	ⲧⲉⲥ
ⲧⲉⲥ	ⲧⲉⲥ
ⲧⲉⲧ̇ⲛ̇	ⲧⲉⲧⲛ
ⲧⲉⲧ̇ⲛ	ⲧⲉⲧⲛ
ⲧⲉⲧⲛ̄	ⲧⲉⲧⲛ
ⲧⲉⲧⲛ̇	ⲧⲉⲧⲛ
ⲧⲉⲧⲛ︥	ⲧⲉⲧⲛ
ⲧⲉⲧⲛ	ⲧⲉⲧⲛ
ⲧⲉⲧ︤ⲛ︥	ⲧⲉⲧⲛ
ⲧⲉⲧ︤ⲛ︥	ⲧⲉⲧⲛ
ⲧⲉⲧ	ⲧⲉⲧⲛ
ⲧⲉⲩ	ⲧⲉⲩ
ⲧⲉⲭⲛⲉ	ⲧⲉⲭⲛⲉ
ⲧⲉⲭⲛⲏ	ⲧⲉⲭⲛⲏ
ⲧⲉ⳯	ⲧⲉⲛ
ⲧⲉ⳿	ⲧⲉ
ⲧⲉ	ⲧⲉ
ⲧⲉ	ⲧⲉ
ⲧⲉ	ⲧⲉ
ⲧⲉ	ⲧⲉ
ⲧⲉ	ⲧⲉ
ⲧⲉ[ⲛ]ⲟⲩ	ⲧⲉⲛⲟⲩ
ⲧⲏ̇ⲣ	ⲧⲏⲣ
ⲧⲏ̇ⲩⲧ︤ⲛ︥	ⲧⲏⲩⲧⲛ
ⲧⲏ̣ϣ̣	ⲧⲏϣ
ⲧⲏϣ	ⲧⲏϣ
ⲧⲏⲣ̣	ⲧⲏⲣ
ⲧⲏⲣ︤	ⲧⲏⲣ
ⲧⲏⲣ	ⲧⲏⲣ
ⲧⲏⲣ	ⲧⲏⲣ
ⲧⲏⲩⲧⲛ̄	ⲧⲏⲩⲧⲛ
ⲧⲏⲩⲧⲛ	ⲧⲏⲩⲧⲛ
ⲧⲏⲩⲧ︤ⲛ︥	ⲧⲏⲩⲧⲛ
ⲧⲏ	ⲧⲏ
ⲧⲓ̈	ⲧⲓ
ⲧⲓⲙⲏ⳿	ⲧⲓⲙⲏ
ⲧⲓⲙⲱⲣⲓⲁ	ⲧⲓⲙⲱⲣⲓⲁ
ⲧⲙ̇	ⲧⲙ
ⲧⲙⲁⲓ̈ⲟ`	ⲧⲙⲁⲓⲟ
ⲧⲙⲙⲁⲩ	ⲙⲙⲁⲩ
ⲧⲙ︤	ⲧⲙ
ⲧⲙ︥︥	ⲧⲙ
ⲧⲙ	ⲧⲙ
ⲧⲛ̄	ⲧⲛ
ⲧⲛ̇	ⲧⲛ
ⲧⲛ̇	ⲧⲛ
ⲧⲛⲉⲧ	ⲧⲛⲉⲧ
ⲧⲛⲛⲟⲟⲩ	ⲧⲛⲛⲟⲟⲩ
ⲧⲛⲧⲱⲛ	ⲧⲛⲧⲱⲛ
ⲧⲛⲧⲱⲛ`	ⲧⲛⲧⲱⲛ
ⲧⲛⲧⲱ⳯	ⲧⲛⲧⲱⲛ
ⲧⲛ︥	ⲧⲛ
ⲧⲛ︥	ⲧⲛ
ⲧⲛ	ⲧⲛ
ⲧⲟ̂	ⲧⲟ
ⲧⲟϣ︤	ⲧⲟϣ
ⲧⲟⲉⲓ̇ⲥ	ⲧⲟⲉⲓⲥ
ⲧⲟⲕ⳿	ⲧⲟⲕ
ⲧⲟⲛⲟⲩ	ⲧⲟⲛⲟⲩ
ⲧⲟⲟⲧ︤	ⲧⲟⲟⲧ
ⲧⲟⲟⲧ	ⲧⲟⲟⲧ
ⲧⲟⲟⲧ	ⲧⲟⲟⲧ
ⲧⲟⲟⲩ	ⲧⲟⲟⲩ
ⲧⲟⲡⲟⲥ⳿	ⲧⲟⲡⲟⲥ
ⲧⲟⲡⲟⲥ	ⲧⲟⲡⲟⲥ
ⲧⲟⲧⲉ	ⲧⲟⲧⲉ
ⲧⲟⲩϫⲉ	ⲧⲟⲩϫⲉ
ⲧⲟⲩϫⲟ	ⲧⲟⲩϫⲟ
ⲧⲟⲩⲛⲟⲥ	ⲧⲟⲩⲛⲟⲥ
ⲧⲟⲩⲱ	ⲧⲟⲩⲱ
ⲧⲟⲩ	ⲧⲟⲩ
ⲧⲣ̣ⲉ	ⲧⲣⲉ
ⲧⲣ̣[ⲉ	ⲧⲣⲉ
ⲧⲣⲉ̣	ⲧⲣⲉ
ⲧⲣⲉ	ⲧⲣⲉ
ⲧⲣⲩⲫⲁ⳿	ⲧⲣⲩⲫⲁ
ⲧⲣ	ⲧⲣⲉ
ⲧⲣ	ⲧⲣ
ⲧⲥⲁⲃⲱ	ⲧⲥⲁⲃⲱ
ⲧⲥⲁⲛⲟ`	ⲧⲥⲁⲛⲟ
ⲧⲥⲟ	ⲧⲥⲟ
ⲧⲱϣ	ⲧⲱϣ
ⲧⲱϣ`	ⲧⲱϣ
ⲧⲱϩ⳿	ⲧⲱϩ
ⲧⲱϩ︤ⲙ︥	ⲧⲱϩⲙ
ⲧⲱϩ︤ⲙ︥	ⲧⲱϩⲙ
ⲧⲱϩ︤ⲥ︥	ⲧⲱϩⲥ
ⲧⲱϩ︤	ⲧⲱϩ
ⲧⲱϭⲉ	ⲧⲱϭⲉ
ⲧⲱϭⲉ`	ⲧⲱϭⲉ
ⲧⲱⲃⲁϩ	ⲧⲱⲃⲁϩ
ⲧⲱⲃ︤ϩ︥	ⲧⲱⲃϩ
ⲧⲱⲗ̣︤ⲙ̣︥	ⲧⲱⲗⲙ
ⲧⲱⲙ	ⲧⲱⲙ
ⲧⲱⲙ`	ⲧⲱⲙ
ⲧⲱⲙ`	ⲧⲱⲙ
ⲧⲱⲛⲉ	ⲧⲱⲛⲉ
ⲧⲱⲛ	ⲧⲱⲛ
ⲧⲱⲛ	ⲧⲱⲛ
ⲧⲱⲛ	ⲧⲱⲛ
ⲧⲱⲛ`	ⲧⲱⲛ
ⲧⲱⲟⲩⲛ̇	ⲧⲱⲟⲩⲛ
ⲧⲱⲟⲩⲛ	ⲧⲱⲟⲩⲛ
ⲧⲱⲣⲡ	ⲧⲱⲣⲡ
ⲧⲱⲣ︤ⲡ︥	ⲧⲱⲣⲡ
ⲧⲱⲧ⳿	ⲧⲱⲧ
ⲧⲱⲧ	ⲧⲱⲧ
ⲧⲱⲧ	ⲧⲱⲧ
ⲧⲱⲱⲃⲉ	ⲧⲱⲱⲃⲉ
ⲧⲱⲱⲃⲉ`	ⲧⲱⲱⲃⲉ
ⲧⲱ⳯	ⲧⲱⲛ
ⲧ⳿	ⲧ
ⲧ︤ⲃ︥ⲃⲏⲩ	ⲧⲃⲃⲏⲩ
ⲧ︤ⲃ︥ⲃⲟ	ⲧⲃⲃⲟ
ⲧ︤ⲃ︥ⲛ̣ⲏ	ⲧⲃⲛⲏ
ⲧ︤ⲃ︥ⲛⲟⲟⲩⲉ⳿	ⲧⲃⲛⲟⲟⲩⲉ
ⲧ︤ⲃ︥ⲛⲟⲟⲩⲉ	ⲧⲃⲛⲟⲟⲩⲉ
ⲧ︤ⲃ︥ⲛⲟⲟⲩⲉ`	ⲧⲃⲛⲟⲟⲩⲉ
ⲧ︤ⲃ︦ⲃ︥ⲟ	ⲧⲃⲃⲟ
ⲧ︤ⲙ̣︥	ⲧⲙ
ⲧ︤ⲙ̣︥	ⲧⲙ
ⲧ︤ⲙ︥ⲙⲟ	ⲧⲙⲙⲟ
ⲧ︤ⲙ︥	ⲧⲙ
ⲧ︤ⲛ̣︥	ⲧⲛ
ⲧ︤ⲛ︥ⲛⲟⲟⲩ	ⲧⲛⲛⲟⲟⲩ
ⲧ︤ⲛ︥ⲛⲟ	ⲧⲛⲛⲟ
ⲧ︤ⲛ︥Ⲧⲱⲛ`	ⲧⲛⲧⲱⲛ
ⲧ︤ⲛ︥ⲧⲱⲛ⳿	ⲧⲛⲧⲱⲛ
ⲧ︤ⲛ︥ⲧⲱⲛ	ⲧⲛⲧⲱⲛ
ⲧ︤ⲛ︥ⲧⲱⲛ	ⲧⲛⲧⲱⲛ
ⲧ︤ⲛ︥ⲧⲱⲛ`	ⲧⲛⲧⲱⲛ
ⲧ︤ⲛ︥ⲧⲱ⳯	ⲧⲛⲧⲱⲛ
ⲧ︤ⲛ︥	ⲧⲛ
ⲧ︤ⲛ︥	ⲧⲛ
ⲧ︤ⲛ︥	ⲧⲛ
ⲧ︤ⲣ︥ⲣⲉ⳿	ⲧⲣⲣⲉ
ⲧ︤ⲥ︥ⲧⲟ	ⲧⲥⲧⲟ
ⲧ︤	ⲧ
ⲧ︥ⲃⲃⲟ̂	ⲧⲃⲃⲟ
ⲧ︥	ⲧ
ⲧ	ⲧ
ⲧ[ⲏⲣ]	ⲧⲏⲣ
ⲧ]	ⲧ
ⲩ̇	ⲩ
ⲩ̇	ⲩ
ⲩ̣	ⲩ
ⲩϣⲏ̂	ⲩϣⲏ
ⲩⲛ̄ⲧⲁ	ⲩⲛⲧⲁ
ⲩⲛ̄	ⲩⲛ
ⲩⲛⲟⲩ	ⲩⲛⲟⲩ
ⲩⲛ	ⲩⲛ
ⲩ	ⲟⲩ
ⲩ	ⲩ
ⲩ	ⲩ
ⲩ	ⲩ
ⲩ	ⲩ
ⲩ]	ⲩ
ⲩ`	ⲩ
ⲩ`	ⲩ
Ⲫⲟⲣⲉⲓ̇	ⲫⲟⲣⲉⲓ
Ⲫⲟⲣⲓ̇	ⲫⲟⲣⲉⲓ
Ⲫⲩⲥⲓ̇	ⲫⲩⲥⲓ
ⲫⲁⲛⲟⲩⲏⲗ`	ⲫⲁⲛⲟⲩⲏⲗ
ⲫⲁⲣⲁⲱ̂	ⲫⲁⲣⲁⲱ
ⲫⲑⲟⲛⲉⲓ	ⲫⲑⲟⲛⲉⲓ
ⲫⲓ̇ⲗⲁⲅⲣⲓ̇ⲟⲥ	ⲫⲓⲗⲁⲅⲣⲓⲟⲥ
ⲫⲟⲛⲟⲥ⳿	ⲫⲟⲛⲟⲥ
ⲫⲟⲣⲉⲓ̇	ⲫⲟⲣⲉⲓ
ⲫⲟⲣⲉⲓ	ⲫⲟⲣⲉⲓ
Ⲭⲱⲣⲓⲥ	ⲭⲱⲣⲓⲥ
ⲭ̇ⲣⲏⲙⲁ	ⲭⲣⲏⲙⲁ
ⲭ̇ⲣⲓ̇ⲁ̇	ⲭⲣⲓⲁ
ⲭⲁⲣⲓⲥ	ⲭⲁⲣⲓⲥ
ⲭⲁⲣⲧⲏⲥ⳿	ⲭⲁⲣⲧⲏⲥ
ⲭⲁⲣⲧⲏⲥ	ⲭⲁⲣⲧⲏⲥ
ⲭⲉⲓⲙⲏⲧⲓ`	ⲭⲉⲓⲙⲏⲧⲓ
ⲭⲏⲣⲁ⳿	ⲭⲏⲣⲁ
ⲭⲏⲣⲁ	ⲭⲏⲣⲁ
ⲭⲣⲉⲓⲁ	ⲭⲣⲉⲓⲁ
ⲭⲣⲉⲓⲥⲧⲓⲁⲛⲟⲥ⳿	ⲭⲣⲉⲓⲥⲧⲓⲁⲛⲟⲥ
ⲭⲣⲏⲙⲁ	ⲭⲣⲏⲙⲁ
ⲭⲣⲓ̇ⲁ̇	ⲭⲣⲓⲁ
ⲭⲣⲓⲁ	ⲭⲣⲓⲁ
ⲭⲱⲣⲁ	ⲭⲱⲣⲁ
ⲭⲱⲣⲓⲥ	ⲭⲱⲣⲓⲥ
ⲭ︤ⲣ︦ⲥ︥	ⲭⲣⲓⲥⲧⲟⲥ
ⲭ︤ⲥ︥	ⲭⲣⲓⲥⲧⲟⲥ
ⲭ︤ⲥ︥	ⲭⲣⲓⲥⲧⲟⲥ
ⲭ︤︤ⲥ︥	ⲭⲣⲓⲥⲧⲟⲥ
ⲭ︦ⲥ︦	ⲭⲣⲓⲥⲧⲟⲥ
ⲯⲩⲭⲏ	ⲯⲩⲭⲏ
ⲯⲩⲭⲏ`	ⲯⲩⲭⲏ
ⲱ̂	ⲱ
ⲱ̇ⲛϩ̇	ⲱⲛϩ
ⲱ̇ⲛⲁϩ	ⲱⲛⲁϩ
ⲱ̇ⲡ	ⲱⲡ
ⲱ̇ⲧⲡ̇	ⲱⲧⲡ
ⲱ̣ϣ̣	ⲱϣ
ⲱϣ	ⲱϣ
ⲱϣ`	ⲱϣ
ⲱϩⲥ̇	ⲱϩⲥ
ⲱϩ︤ⲥ︥	ⲱϩⲥ
ⲱϩ︤ⲧ︥	ⲱϩⲧ
ⲱϫ︤ⲛ︥	ⲱϫⲛ
ⲱϭⲉ	ⲱϭⲉ
ⲱⲇⲏ⳿	ⲱⲇⲏ
ⲱⲗ⳿	ⲱⲗ
ⲱⲛϩ	ⲱⲛϩ
ⲱⲛϩ	ⲱⲛϩ
ⲱⲛ︤ϩ︥	ⲱⲛϩ
ⲱⲛ︤ϩ︥	ⲱⲛϩ
ⲱⲛ︤ϩ︥`	ⲱⲛϩ
ⲱⲟⲟⲡ`	ⲱⲟⲟⲡ
ⲱⲡ⳿	ⲱⲡ
ⲱⲣ︤ϫ︥⳿	ⲱⲣϫ
ⲱⲥⲕ︥	ⲱⲥⲕ
ⲱⲥⲕ	ⲱⲥⲕ
ⲱ︤ⲣ̄ϫ︥	ⲱⲣϫ
ⲻ	·
ⲻ	ⲻ
ⲻ	.
⳯ⲧ	ⲛⲧ
⳯	ⲛ
⳯	ⲛ
⳯	ⲛ
⳯	ⲛ
⳾	⳾
⸖	⸖
⸱	,
⸱	.
︤ϥ︥	ϥ
︤ⲅ	ⲅ
︤ⲛ︥ⲕⲟⲧ︤ⲕ︥	ⲛⲕⲟⲧⲕ
 ⲁ̇ⲗⲗⲁ	ⲁⲗⲗⲁ
 ⲙ̄	ⲙ
 ⲥⲛⲏⲩ`	ⲥⲛⲏⲩ
  ϫⲉ	ϫⲉ
 =–	.
 =–.	.
 =ⲻ	.
 =-.	.
,	,
.ⲻ	.
.	,
.	.
.	.
..	..
.]	[.]
:ⲻ	.
:ⲻ.	.
:	:
=	.
[ϣⲓⲡⲉ]	ϣⲓⲡⲉ
[ϥⲟ	ϥⲟ
[ϩ̣]ⲃⲏⲩⲉ	ϩⲃⲏⲩⲉ
[ϩⲁⲡ]	ϩⲁⲡ
[ϩⲁⲣⲟ	ϩⲁⲣⲟ
[ϩⲁ	ϩⲁ
[ϩⲛ	ϩⲛ
[ϩⲛ]	ϩⲛ
[ϩⲱ]ⲱ	ϩⲱⲱ
[ϫⲉ	ϫⲉ
[ϫⲟ]ⲉⲓⲥ`	ϫⲟⲉⲓⲥ
[ϫⲟ]ⲟ	ϫⲟⲟ
[ϭⲓ]ⲛ	ϭⲓⲛ
[…..]ⲉ̣ⲁ	[…..]ⲉⲁ
[ⲁϣⲏ]	ⲁϣⲏ
[ⲁⲛⲟⲙⲓⲁ]	ⲁⲛⲟⲙⲓⲁ
[ⲁ	ⲁ
[ⲁ]ⲙⲱⲛⲁ	ⲁⲙⲱⲛⲁ
[ⲃ̣ⲱ̣]ϣ̣	ⲃⲱϣ
[ⲉ̣ⲧ]	ⲉⲧ
[ⲉⲧⲃⲏ]ⲏⲧ	ⲉⲧⲃⲏⲏⲧ
[ⲉⲧ]	ⲉⲧ
[ⲉ	ⲉ
[ⲉ	ⲉ
[ⲉ]ϣ̣ϫⲉ	ⲉϣϫⲉ
[ⲉ]ⲓ	ⲉⲓ
[ⲉ]ⲛϣⲁⲛ	ⲉⲛϣⲁⲛ
[ⲉ]ⲛⲧ	ⲉⲛⲧ
[ⲉ]ⲣ̣ⲟ	ⲉⲣⲟ
[ⲉ]	ⲉⲧ
[ⲏ	ⲏ
[ⲕⲏ	ⲕⲏ
[ⲕⲗⲏ]ⲣⲟⲛⲟⲙⲉⲓ	ⲕⲗⲏⲣⲟⲛⲟⲙⲉⲓ
[ⲙ̣ⲟⲧⲉ]	ⲙⲟⲧⲉ
[ⲙⲙ]ⲁⲩ	ⲙⲙⲁⲩ
[ⲙ]ⲁ̣ⲩⲁⲁ	ⲙⲁⲩⲁⲁ
[ⲛ̣̄	ⲛ
[ⲛ̣̄]	ⲛ
[ⲛ̄ⲧ	ⲛⲧ
[ⲛϩⲏ]	ⲛϩⲏ
[ⲛϭⲓ]	ⲛϭⲓ
[ⲛⲓ]ⲙ	ⲛⲓⲙ
[ⲛⲟϭ	ⲛⲟϭ
[ⲛⲟ]ϭ	ⲛⲟϭ
[ⲛ	ⲛ
[ⲛ]ϭⲓ	ⲛϭⲓ
[ⲛ]	ⲛ
[Ⲟⲩ	ⲟⲩ
[ⲟⲩⲉϩ]	ⲟⲩⲉϩ
[ⲟⲩⲟⲉⲓ]ϣ	ⲟⲩⲟⲉⲓϣ
[ⲟⲩ	ⲟⲩ
[ⲡⲁ]ⲑ̣ⲟⲥ	ⲡⲁⲑⲟⲥ
[ⲡ	ⲡ
[ⲡ]ⲉϫⲁ	ⲡⲉϫⲁ
[ⲡ]	ⲡ
[ⲥⲏϩ̣	ⲥⲏϩ
[ⲥ]ⲱⲱ	ⲥⲱⲱ
[ⲧⲏ]ⲣ	ⲧⲏⲣ
[ⲧⲣⲉ	ⲧⲣⲉ
[ⲩ]	ⲩ
[ ]	[ ]
[----]	----
[..........]	[..........]
[.........]	[.........]
[........]	[........]
[.......]	[.......]
[.....]ⲡ̣ⲣ̣[..][....]ⲥ̣	[.....]ⲡⲣ[..][....]ⲥ
[.....]ⲩⲟ	[.....]ⲩⲟ
[.....]	[.....]
[.....]	[.....]
[....]ϫ̣ⲉ	[....]ϫⲉ
[....]ⲥ̣	[....]ⲥ
[....]ⲥⲧⲁ`	[....]ⲥⲧⲁ
[....]	[....]
[...]ϥ̣	[...]ϥ̣
[...]ⲛ̄	[...]ⲛ
[...]ⲟⲧ︤ⲡ︥	[...]ⲟⲧⲡ
[...]ⲩ̣	[...]ⲩ
[...]	[...]
[..]ⲁⲩ	[..]ⲁⲩ
[..]ⲉ̣	ϫⲉ
[..]ⲙⲉ	[..]ⲙⲉ
[..]ⲥ̣ⲃⲱ`	[..]ⲥⲃⲱ
[..]ⲱ	ϫⲱ
[..]	[..]
[.]ⲉ	[.]ⲉ
[.]ⲙ	[.]ⲙ
[.]ⲛ	[.]ⲛ
[.]	.
cⲟ̇ⲛ	cⲟⲛ
·̣	·
·ⲻ	·ⲻ
·ⲻ	·
·ⲻ	,
·ⲻ	.
·	·
·	—
·	,
·	.
·	?
·	·
·]	·
̀ⲉϩⲣⲁⲓ̈	ⲉϩⲣⲁⲓ
̇ϣⲁ	ϣⲁ
̇ⲙ̄ⲡ︤	ⲙⲡ
̇ⲙⲁⲕⲁⲣⲓ̇ⲁ	ⲙⲁⲕⲁⲣⲓⲁ
̇ⲛ̇	ⲛ
̣·	·
̣̣ⲛ̣[ⲟ]ⲩ̣ⲧⲉ	ⲛⲟⲩⲧⲉ
̣ϣⲱⲡ̣ⲉ	ϣⲱⲡⲉ
̣ⲛ̣	ⲛ
ⲉϩⲣⲁⲉⲓ	ⲉϩⲣⲁⲓ
ϩⲣⲁⲉⲓ	ϩⲣⲁⲓ
ϣⲁϩⲣⲁⲉⲓ	ϣⲁϩⲣⲁⲓ
ⲓⲥ	ⲓⲏⲥⲟⲩⲥ
ⲓⲏⲥ	ⲓⲏⲥⲟⲩⲥ
ⲓⲏⲗ	ⲓⲥⲣⲁⲏⲗ
ⲭⲥ	ⲭⲣⲓⲥⲧⲟⲥ
ⲭⲣⲥ	ⲭⲣⲓⲥⲧⲟⲥ
ⲓⲉⲣⲟⲥⲟⲗⲩⲙⲁ	ϩⲓⲉⲣⲟⲥⲟⲗⲩⲙⲁ
ϩⲓⲗⲏⲙ	ⲓⲉⲣⲟⲥⲟⲗⲩⲙⲁ
ⲡⲉⲉⲓ	ⲡⲉⲓ
ⲛⲉⲉⲓ	ⲛⲉⲓ
ϩⲓⲁⲓⲃⲉ	ϩⲓⲉⲓⲃ
ϩⲓⲁⲃⲉ	ϩⲓⲉⲓⲃ